//replace " with ' or \"
var data1 = "\
ˈæbəkəs|ˈæbəkəs}-{abacus}-{use abacus for statistic}-{n. 算盘； <建>（圆柱）顶板；|,|\
əˈbɔ:d|əˈbɔrd}-{aboard}-{The boat swayed as he stepped aboard.}-{prep. 在（船、飞机、车）上，上（船、飞机、车）； 上车；|adv. 在船（或飞机、车）上，上船（或飞机、车）； 靠船边； 在船上； 在火车上|,|\
ˈæbsənt|ˈæbsənt}-{absent}-{students who are regularly absent from school ;absent yourself (from something)}-{adj. 缺席的，不在场的； 缺少的，缺乏的； 不在意的，茫然的；|,|\
əˈbʌndəns|əˈbʌndəns}-{abundance}-{an abundance of wavy red hair ;in abundance}-{n. 丰富，充裕； 大量，极多； 盈余； 丰度|,|\
əˈbʌndənt|əˈbʌndənt}-{abundant}-{v abound;an abundant supply of fresh water}-{adj. 大量的，充足的； 丰富的，富有的； 丰足； 阜|,|\
əkˈseləreɪt|ækˈsɛləˌret}-{accelerate}-{decelerate;The car accelerated smoothly away.}-{vt. （使）加快，（使）增速； 加速，催促； 促进； 速度增加|vi. 加快，加速；|,|\
ˈæksent|ˈækˌsɛnt}-{accent}-{Irish accent}-{n. 重音； 口音； 腔调； 重音符号（标在字母上）|,|\
əkˈseptəns|ækˈsɛptəns}-{acceptance}-{the formal acceptance of an invitation}-{n. 接受，接纳； [金融]承兑； 无怨接受（逆境、困境等）； 赞成|,|\
ˌæksɪˈdentl|ˌæksɪˈdɛntl}-{accidental}-{accidental death}-{adj. 意外的，偶然（发生）的； 附属的；|n. 偶然； 次要方面；|,|\
əˈkʌmplɪʃ|əˈkɑmplɪʃ}-{accomplish}-{We have accomplished all we set out to do.}-{vt. 完成； 达到（目的）； 走完（路程、距离等）； 使完美|,|\
əˈkɔ:d|əˈkɔrd}-{accord}-{discord;He decided to go of his own accord. ;The punishments accorded with the current code of discipline.}-{n. 协议； 条约； （色彩的）协调； 和解协议|vt. 给予； 使和谐一致； 使符合； 使适合|vi. 符合； 一致；|,|\
əˈkɔ:dns|əˈkɔrdns}-{accordance}-{in accordance with international law .}-{n. 一致； 和谐； 给予；|,|\
əˈkɔ:dɪŋli|əˈkɔrdɪŋli}-{accordingly}-{according adv. 依照;Katherine still considered him a child and treated him accordingly.}-{adv. 因此，于是； 依据； 照着，相应地；|,|\
əˈkaʊntənt|əˈkaʊntənt}-{accountant}-{professional accountant}-{n. 会计人员，会计师；|,|\
əˈkʌstəmd|əˈkʌstəmd}-{accustomed}-{be accustomed to (doing) something ;become/grow/get accustomed to something}-{adj. 习惯的； 通常的； 独有的； 适应的|v. 使习惯于(accustom的过去式和过去分词)；|,|\
eɪk|ek}-{ache}-{He ached to reach out and hold her close. ;I’m aching for sleep}-{n. 疼痛；|vi. 疼痛； 渴望；|,|\
əˈkweɪntəns|əˈkwentəns}-{acquaintance}-{mutual acquaintance ;have a passing/nodding acquaintance with something}-{n. 相识的人，熟人； 相识； 对…有了解； 知识，心得|,|\
ˈeɪkə(r)|ˈekɚ}-{acre}-{They own 200 acres of farmland.}-{n. 英亩； 土地，耕地； [口]大量；|,|\
əˈkju:t|əˈkjut}-{acute}-{acute pain ; blunt}-{adj. 尖的，锐的； 敏锐的，敏感的； 严重的，剧烈的； [医]急性的|,|\
ədˈventʃə(r)|ædˈvɛntʃɚ}-{adventure}-{an adventure story}-{n. 冒险活动； 冒险经历； 奇遇；|,|\
ədˈvaɪzəbl|ædˈvaɪzəbəl}-{advisable}-{It is advisable to}-{adj. 明智的； 可取的； 能劝告的； 适当的|,|\
eərəʊ|'eroʊ}-{aero}-{an aeroengine}-{adj. 航空的，飞行的，飞机的；|,|\
ˈeərəpleɪn|ˈerəpleɪn}-{aeroplane}-{a small aeroplane}-{n. 飞机；|,|\
əˈfekʃn|əˈfɛkʃən}-{affection}-{win sb's affection}-{n. 喜爱，慈爱； 情感或感情； 意向； 疾病，病情|,|\
ɑ:ftəwəd|ˈæftəwəd}-{afterward}-{days/weeks etc afterwards}-{adv. <美>以后，过后；|,|\
əˈdʒendə|əˈdʒɛndə}-{agenda}-{be high on the agenda/be top of the agenda ;political/economic/legislative/domestic etc agenda}-{n. 议事日程； 待议诸事项一览表； 日常工作事项； 议程（ agendum的名词复数）|,|\
ˈeəpleɪn|ˈerpleɪn}-{airplane}-{by airplane}-{n. <美>飞机；|,|\
aɪl|aɪl}-{aisle}-{aisle seat ;be rolling in the aisles}-{n. 过道，通道； 侧廊，耳堂； 狭长的通路；|,|\
əˈlɜ:t|əˈlɜrt}-{alert}-{be alert to the possibility of invasion. ;alert somebody to something}-{adj. 警觉的，警惕的，注意的； 思维敏捷的； 活泼的；|n. 警报； 警戒状态；|vt. 向…报警；|,|\
əˈlaɪk|əˈlaɪk}-{alike}-{My mother and I are alike in many ways. ;The twins were dressed alike.}-{adj. 同样的，相似的；|adv. 同样地； 两者都，同样地； 类似于；|,|\
əˈlaɪəns|əˈlaɪəns}-{alliance}-{The companies have formed an alliance to market the product.}-{n. （国家、政党等的）结盟，同盟，联盟，联合； 联姻； 同盟条约； 同盟者|,|\
ˈælaɪ|'ælaɪ}-{ally}-{closest allies . ;ally yourself to/with somebody}-{n. 同盟国，同盟者； 助手，支持者； 协约国； 联盟|vt.&vi. （使）联盟，（使）同盟； （使）结盟，（使）联姻；|,|\
ˈælfəbet|ˈælfəˌbɛt, -bɪt}-{alphabet}-{The modern Russian alphabet}-{n. 字母表； 字母系统； 入门，初步；|,|\
ˈæltɪtju:d|ˈæltɪtud}-{altitude}-{At high altitudes it is difficult to get enough oxygen.}-{n. 高度，海拔高度； 高位，高等； [天]地平纬度； [数]顶垂线|,|\
ə'lju:minəm|ə'ljuminəm}-{aluminum}-{aluminum cans ;aluminum and nickel}-{n. <美>铝；|,|\
ˈæmətə(r)|ˈæmətər}-{amateur}-{amateur runners;political amateur}-{n. 业余爱好者； 外行，生手；|adj. 业余的，非职业的； 外行的；|,|\
əˈmeɪz|əˈmez}-{amaze}-{It still amazes me how much she has improved.}-{vt. 使大为吃惊，使惊奇；|n. 吃惊，好奇；|,|\
æmˈbæsədə(r)|æmˈbæsədɚ, -ˌdɔr}-{ambassador}-{the German ambassador to Poland}-{n. 大使，使节； （派驻联合国等国际组织的）代表； 特使； [比喻]使者|,|\
æmˈbɪʃəs|æmˈbɪʃəs}-{ambitious}-{intensely ambitious}-{adj. 有雄心的； 有野心的； 费力的； 耗资的|,|\
əˈmɪd|ə'mɪd}-{amid}-{He sat amid the trees.}-{prep. （表示位置）在…中间； （表示环境）处于…环境中； 由于存在…情况； （表示让步）尽管有…的情况|,|\
ə'mʌŋst|əˈmʌŋst}-{amongst}-{Amongst others we have lots of Tutorials}-{prep. （表示位置）处在…中； （表示范围）在…之内； （表示牵涉）经过； （表示所属）为…所特有|,|\
əˈmju:z|əˈmjuz}-{amuse}-{music;it amuses somebody to do something}-{vt. 使人发笑； 逗乐； 使消遣； 娱乐|,|\
ˈænsestə(r)|ˈænˌsɛstɚ}-{ancestor}-{My ancestors were French.}-{n. 祖先，祖宗； 被继承人； 原型； （动物的）原种，先祖|,|\
ˈæŋkə(r)|ˈæŋkɚ}-{anchor}-{The ship was at anchor. ;Her life was anchored by her religion.}-{n. 锚； 锚状物； 靠山； 压阵队员|vt. 抛锚，抛锚泊船； 使固定，使稳固； 使稳定； 在…任节目主持人|vi. 抛锚，停泊； 固定； [体]任主要运动员； 主持节目|adj. 最后一棒的，末捧的；|,|\
ˈæŋkl|ˈæŋkəl}-{ankle}-{John twisted his ankle badly.}-{n. 踝，踝关节； 脚脖子；|,|\
ˌænɪˈvɜ:səri|ˌænɪˈvɜrsəri}-{anniversary}-{one hundredth anniversary of the birth of Ho Chi Minh}-{n. 周年纪念日；|adj. 周年的； 周年纪念的； 年年的； 每年的|,|\
ænˈti:k|ænˈtik}-{antique}-{an antique shop ;an antique rosewood desk}-{adj. 古老的，古代的； 过时的，古董的； 古时制造的； 古风的|n. 古玩，古董； 古风，古希腊和古罗马艺术风格；|v. 仿古制作； 使显得古色古香； 寻觅古玩；|,|\
ˈæpɪtaɪt|ˈæpɪˌtaɪt}-{appetite}-{Her husband always had a huge appetite.}-{n. 欲望； 胃口，食欲； 嗜好，爱好；|,|\
əˈplɔ:z|əˈplɔz}-{applause}-{rapturous/enthusiastic applause}-{n. 热烈鼓掌； 喝彩； 掌声；|,|\
əˈplaɪəns|əˈplaɪəns}-{appliance}-{domestic/household etc appliance ;electrical/gas appliance}-{n. 器具，器械，装置； 家用电器；|,|\
əˈplɪkəbl|ˈæplɪkəbəl, əˈplɪkə-}-{applicable}-{The offer is only applicable to bookings for double rooms.}-{adj. 适当的； 可应用的；|,|\
ˈæplɪkənt|ˈæplɪkənt}-{applicant}-{successful/unsuccessful applicant ;He was one of 30 applicants for the manager’s job.}-{n. 申请人，求职人； 请求者；|,|\
əˈpreɪz|əˈprez}-{appraise}-{appraise the environmental costs}-{vt. 估价； 估计； 估量； 评价，鉴定|,|\
əˈprɒksɪmətli|əˈprɑksɪmətli}-{approximately}-{The plane will be landing in approximately 20 minutes.}-{adv. 近似地，大约； 许；|,|\
əˈrɪθmətɪk|əˈrɪθmɪtɪk}-{arithmetic}-{the arithmetic mean (= average )}-{n. 算术，计算； 算法；|,|\
əˈraʊz|əˈraʊz}-{arouse}-{arouse interest/expectations}-{vt. 引起； 唤醒； 激起性欲； 使行动起来|,|\
ˈærəʊ|ˈæroʊ}-{arrow}-{Follow the arrows to the X-ray department.}-{n. 矢，箭； 箭状物； 箭头记号； [天]天箭座|,|\
ɑ:ˈtɪstɪk|ɑrˈtɪstɪk}-{artistic}-{artistic work ;food presented in an artistic way}-{adj. 艺术的； 有美感的； 风雅的； （尤指）有美术才能的|,|\
æʃ|æʃ}-{ash}-{The house burnt to ashes.}-{n. 灰，灰烬； 灰色，苍白； 骨灰； 废墟|,|\
ˈæset|ˈæsˌɛt}-{asset}-{the value of a company’s assets}-{n. 资产，财产； 有价值的人或物； 有用的东西； 优点|,|\
əˈstɒnɪʃ|əˈstɑnɪʃ}-{astonish}-{It astonished him that}-{vt. 使惊讶，使大为吃惊；|,|\
ˈæθli:t|ˈæθˌlit}-{athlete}-{a great athlete.}-{n. 运动员； 体育家； 强壮的人；|,|\
əˈtɒmɪk|əˈtɑmɪk}-{atomic}-{an atomic submarine}-{adj. 原子的； 原子能的，原子武器的； 极微的；|,|\
ˈɔ:kʃn|ˈɔkʃn}-{auction}-{paintings were put up for auction. ;be auctioned next week}-{n. 拍卖； 竞卖； 标售； （桥牌）拍卖玩法|vt. 拍卖； 竞卖；|,|\
ˈɔ:diəʊ|ˈɔdioʊ}-{audio}-{audio and video equipment}-{adj. 听觉的，声音的； 音频的；|n. 声音回路； 音响； 可听到的声音； 声音信号|,|\
ˈɔ:təʊ|ˈɔtoʊ}-{auto}-{imported autos}-{n. <美>汽车；|vi. 乘汽车；|,|\
ˈɔ:təməbi:l|ˌɔtəmoˈbil, -ˈmoˌbil}-{automobile}-{the automobile industry}-{n. <美>汽车；|v. 开汽车，坐汽车；|,|\
ɔ:gˈzɪliəri|ɔɡˈzɪljəri, -ˈzɪləri}-{auxiliary}-{an auxiliary nurse}-{adj. 辅助的； 备用的，补充的； 附加的； 副的|n. 助动词； 辅助者，辅助人员； 附属机构，附属团体； 辅助设备|,|\
ˈævənju:|ˈævənu}-{avenue}-{The president wants to explore every avenue towards peace in the region.}-{n. 林荫路； 大街； 途径，手段； 〈美〉（南北向）街道|,|\
ˌeɪviˈeɪʃn|ˌeviˈeʃən,ˌævi-}-{aviation}-{the aviation industry;civil aviation}-{n. 航空； 飞行术，航空学； 飞机制造业； [集合词]飞机|,|\
əˈweɪt|əˈwet}-{await}-{A terrible surprise awaited them at Mr Tumnus’ house.}-{vt. 等候； 等待； 期待；|,|\
æks|æks}-{ax}-{TV’s longest running show is to be axed.}-{n. 斧头；|v. 削减； 解雇；|,|\
ˈbætʃələ(r)|ˈbætʃəlɚ, ˈbætʃlɚ}-{bachelor}-{Bachelor of Arts/Science/Education etc}-{n. 学士； 单身汉； 尚未交配的幼雄兽； 侍从|,|\
ˈbæfl|ˈbæfəl}-{baffle}-{The question baffled me completely.}-{vt. 使受挫折； 使困惑，使迷惑； 用隔音板隔音； 挡住（水流等）|n. 隔板，挡板； 迷惑； 遮护物，阻碍体； [军]迷彩|,|\
ˈbæleɪ|bæˈle,ˈbælˌe}-{ballet}-{We’re going to the ballet tomorrow evening.;ballot t发音}-{n. 芭蕾舞； 芭蕾舞剧； 芭蕾舞团； 芭蕾舞音乐|,|\
ˈbaʊndri|ˈbaʊndəri, -dri}-{boundary}-{a natural boundary between}-{n. 分界线； 范围； （球场）边线；|,|\
breɪk|brek}-{brake}-{brakes failed;brake sharply/hard ;put the brakes on}-{n. 制动器，闸； 刹车； 阻碍；|vt.& vi. 刹（车）；|,|\
brænd|brænd}-{brand}-{What brand of detergent do you use? ;brand somebody (as) something}-{n. [商]商标，牌子； 烙印； 〈比喻〉污名，耻辱； 燃烧着的木头|vt. 污辱； 铭刻于； 加商标于； 打烙印于|,|\
brɑ:s|bræs}-{brass}-{an old brass bedstead}-{n. 黄铜； 铜管乐器； 钱； 黄铜饰品（尤指马挽具上的黄铜圆片）|v. 〈英〉付（款）； [冶]把…包铜； 〈口〉无耻地胡搞；|,|\
bredθ|brɛdθ}-{breadth}-{length;the breadth of the river}-{n. 宽度； 宽容； （知识、兴趣等的）广泛；|,|\
ˈbreɪkθru:|ˈbrekˌθru}-{breakthrough}-{Scientists have made a major breakthrough in the treatment of cancer}-{n. 突破； 穿透； 重要技术成就； 炉衬烧穿|,|\
bri:d|brid}-{breed}-{Eagles breed during the cooler months of the year}-{vt. 产（后代），生； 产生，导致； 优生交配； 养育，训练|vi. 产仔； 繁殖，旺盛生长；|n. 属； 种类； 类型； 血统|,|\
bri:z|briz}-{breeze}-{flowers waving in the breeze ;She just breezed into my office and said she wanted a job.}-{n. 微风； 轻而易举的事；|vi. 吹微风； 逃走；|,|\
braɪd|braɪd}-{bride}-{groom}-{n. 新娘，即将（或刚刚）结婚的女子； 姑娘；|,|\
ˈbri:fkeɪs|ˈbrifˌkes}-{briefcase}-{He popped a letter out of his briefcase}-{n. 公文包； 手提包； 公事包； 手提箱|,|\
bru:m|brum,brʊm}-{broom}-{broom the porch 打扫门廊}-{n. 扫帚； 金雀花； [无线]自动搜索干扰振荡器；|vt. 扫除； 用扫帚扫；|vi. 桩顶开花或开裂；|,|\
braʊ|braʊ}-{brow}-{mop/wipe your brow ;your brow furrows/creases/wrinkles}-{n. 眉，眉毛； 前额； 容貌，表情； 山脊|,|\
ˈbru:tl|ˈbrutl}-{brutal}-{brutal murder/attack/assault}-{adj. 野蛮的； 残忍的； 不讲理的； 无情的|,|\
bʌlb|bʌlb}-{bulb}-{a 100-watt bulb}-{n. 球茎，块茎植物； 电灯泡； [解剖学]肿块；|,|\
ˈbʊlɪt|ˈbʊlɪt}-{bullet}-{a bullet wound}-{n. 子弹，弹药； 弹丸； [印]着重号；|,|\
ˈbʌndl|ˈbʌndl}-{bundle}-{a bundle of old clothes;They bundled Perez into the car and drove off.}-{n. 捆； 一批（同类事物或出售的货品）； 一大笔钱； 风趣的人|vt.& vi. 收集，归拢，把…塞入；|vt. 额外免费提供（设备等），（尤指出售计算机时）赠送软件；|vi. 匆匆送走； 推搡； 赶； （成群地）匆忙赶往|,|\
ˈbjʊərəʊ|ˈbjʊroʊ}-{bureau}-{an employment bureau}-{n. 局； （提供某方面信息的）办事处； （美国政府部门）局； （附抽屉及活动写字台的）书桌|,|\
ˈbʌtəflaɪ|ˈbʌtərflaɪ}-{butterfly}-{Gwen’s a real social butterfly .}-{n. 蝴蝶； 蝶泳； 轻浮的人； 游手好闲的人|v. 切开摊平；|,|\
ˈkæbɪdʒ|ˈkæbɪdʒ}-{cabbage}-{The cabbage is overcooked}-{n. 甘蓝（洋白菜、卷心菜）； <非正式、侮辱>植物人，常用于英式英语； <俚>钱，尤指纸币，常用于美式俚语； <俚>脑袋|,|\
ˈkæbɪn|ˈkæbɪn}-{cabin}-{a log cabin}-{n. <美>小木屋； 客舱； （轮船上工作或生活的）隔间；|vt. 把…关在小屋里； 使受拘束；|vi. 住在小屋里；|,|\
ˈkæləri|ˈkæləri}-{calorie}-{a low-calorie snack ;I need to burn off a few calories}-{n. 大卡； 千卡（食物所产生的能量单位）； 卡路里； 卡（热量单位）|,|\
ˈkæml|ˈkæməl}-{camel}-{camel caravan}-{n. 骆驼；|,|\
ˈkæmpəs|ˈkæmpəs}-{campus}-{a rally at the campus.}-{n. 校园； 校区；|,|\
kəˈnæl|kəˈnæl}-{canal}-{the Panama Canal ;by canal}-{n. 运河，沟渠； 管道； 气管； 食道|vt. 建运河； 疏导；|,|\
ˈkæptɪv|ˈkæptɪv}-{captive}-{a pilot who was held captive ;}-{adj. 被俘的； 被监禁的； 被关押的； 无法逃离的|n. 战俘，俘虏； 被（爱情等）迷住的人； 自保公司；|,|\
ˈkɑ:bən|ˈkɑrbən}-{carbon}-{carbon emissions;carbon dioxide}-{n. [化学]碳； （一张）复写纸； [电]碳精棒[片，粉]，碳精电极； 复写的副本|adj. 碳的； 碳处理的；|,|\
ˈkɑ:gəʊ|ˈkɑrgoʊ}-{cargo}-{load a cargo}-{n. （船或飞机装载的）货物； 负荷，荷重；|,|\
ˈkɑ:pəntə(r)|ˈkɑrpəntə(r)}-{carpenter}-{He is a carpenter by profession}-{n. 木工，木匠；|v. 当木匠； 做木工活；|,|\
ˈkærɪdʒ|ˈkærɪdʒ}-{carriage}-{Canals were originally built for the carriage of coal.}-{n. 运输，输送； （旧时载客的）四轮马车； 〈英〉火车客车车厢； 运费|,|\
kɑ:t|kɑrt}-{cart}-{Household waste is carted away by the city’s Sanitation Department.}-{n. 运货马车，手推车； 一车之量；|vt. 用推车或卡车运送； 费力搬运； 强行带走，抓走；|,|\
kæˈʃɪə(r)|kæˈʃɪr}-{cashier}-{The cashier absconded with the money}-{n. 出纳员；|vt. 解雇； 抛弃；|,|\
ˈkæʒuəl|ˈkæʒuəl}-{casual}-{a casual manner}-{adj. 偶然的； 临时的； 随便的； 非正式的|n. 临时工人； [军]待命士兵； 没有固定工作的劳动者； 不定期领取救济金的人|,|\
ˈkæʒuəlti|ˈkæʒuəlti}-{casualty}-{cause/inflict casualties}-{n. 伤亡（人数）； 事故，横祸； 受害者，死伤者； 损坏|,|\
kætəlɔ:g|ˈkætlˌɔɡ, -ˌɑɡ}-{catalog}-{a mail order catalog;directory}-{n. 目录，目录册，目录簿； [美]大学概况一览； 登记，记载； 产品样本|vt. 登记； 为…编目； 编目录； 记载|v. 把…按目录分类； 把…编目；|,|\
ˈkætl|ˈkætl}-{cattle}-{herds of cattle}-{n. （总称）牛，牲口； 畜生； 无价值的人； 〈美俚〉女学生|,|\
ˈkɔ:ʃəs|ˈkɔʃəs}-{cautious}-{a cautious driver}-{adj. 小心的，谨慎的； 兢； 恮； 持重|,|\
sɪˈment|sɪˈmɛnt}-{cement}-{a bag of cement ;cement a relationship/alliance}-{n. 水泥； 胶合剂； 胶接剂； 粘固粉|vt. 粘牢； 巩固； （用水泥、胶等）粘结； 在…上抹水泥|,|\
ˈsensəs|ˈsɛnsəs}-{census}-{a traffic census}-{n. 人口普查，统计； 人口财产调查；|,|\
sentə|ˈsɛntɚ}-{center}-{be the centre of attention}-{n. 中心； （球队的） 中锋； 中心区； 中枢|adj. 中央的，位于正中的； （在）中心的；|vt. 集中； 使聚集在一点； 定中心； 居中|vi. 居中，有中心，被置于中心；|,|\
ˈsentɪgreɪd|ˈsɛntɪˌɡred}-{centigrade}-{30° Centigrade}-{adj. 百分度的； 摄氏的； 摄氏温度计的；|n. 摄氏；|,|\
sentɪˌmi:tə|ˈsɛntəˌmitɚ}-{centimeter}-{.}-{n. 厘米；|,|\
ˈserəməni|ˈserəmoʊni}-{ceremony}-{without ceremony}-{n. 典礼，仪式； 礼仪，礼节； 虚礼，客气；|,|\
ˈtʃeɪmbə(r)|ˈtʃembɚ}-{chamber}-{The heart has four chambers.}-{n. 室，卧室，会客室； 内庭； [多用于英国]律师的办公室； 议事厅|vt. 限制，幽禁，封闭或限制； 使备有房间；|,|\
ˈkeɪɒs|ˈkeɪɑs}-{chaos}-{The kitchen was in chaos.}-{n. 混乱，紊乱； （天地未出现的）浑沌世界； 〈古〉无底深渊； 一团糟|,|\
tʃɑ:m|tʃɑrm}-{charm}-{charm sb; no charm}-{n. 魔力； 魅力； 咒文； （表链等的）小装饰品|vt. 使陶醉； 诱惑； 对…行魔法； 令人陶醉|,|\
ˈtʃɑ:tə(r)|ˈtʃɑrtə(r)}-{charter}-{We chartered a boat}-{n. 许可证； 纲领； 宪章； 包租|vt. 发给…许可证； 发给特许执照；|,|\
ˈtʃɪəfl|ˈtʃɪrfl}-{cheerful}-{cheerful voice/smile/manner etc}-{adj. 欢乐的，高兴的； 令人愉快的；|,|\
tʃu:|tʃu}-{chew}-{chew your food well;a dog chewing on a bone}-{vt.& vi. 咀嚼，咬； 深思，考虑；|n. 咀嚼； 咀嚼物；|,|\
tʃɪl|tʃɪl}-{chill}-{morning/autumnal/January etc chill ;chill of fear/apprehension/disquiet etc}-{vt.& vi. （使）变冷； 使很冷； 使冰冷； 使恐惧|n. 寒冷，发冷； 冷漠； 扫兴； [冶金学]激冷|adj. 冷的； 冷漠的； 令人失望的；|vt. 令失望； 使沮丧； 使扫兴； 使消沉|,|\
tʃɪn|tʃɪn}-{chin}-{He rubbed his chin thoughtfully.}-{n. （尤指人的）颏，下巴； 聊天； 引体向上动作；|v. 用下巴夹住； 聊天； 作引体向上动作；|,|\
tʃəʊk|tʃoʊk}-{choke}-{the fumes almoust choked me}-{vt.& vi. 阻止，扼止； 填塞； 使窒息； 哽咽|n. 窒息，哽咽； 拥塞； （车辆发动机的）阻风门；|,|\
kraɪst|kraɪst}-{Christ}-{the teachings of Christ;before christ}-{n. 基督； 救世主；|int. 〈俚〉哎呀；|,|\
ˈkrɪstʃən|ˈkrɪstʃən}-{Christian}-{That wasn’t a very christian thing to do!}-{n. 基督教徒，信徒； 克里斯琴； <口>人类，文明人，正派人； [电影]克里斯蒂安|adj. 信基督教的，基督教的，基督教徒的； <口>人（类）的，文明的，<口>正派的，高尚的；|,|\
sɪˈgɑ:(r)|sɪˈɡɑr}-{cigar}-{He was smoking a big cigar}-{n. 雪茄； 叶卷烟；|,|\
ˈsɜ:kjələ(r)|ˈsɜrkjələ(r)}-{circular}-{a circular table ; circular argument/logic/reasoning}-{adj. 圆形的； 环行的； 迂回的，绕行的； 供传阅的，流通的|n. 通知，通告； 印制的广告，传单；|,|\
ˈsɜ:kjəleɪt|ˈsɜrkjəleɪt}-{circulate}-{Ceiling fans circulated warm air around the room.}-{vt.& vi. （使）循环； （使）流通； （使）流传； 散布|vi. 传送，传递，传阅；|,|\
səˈvɪliən|sɪˈvɪljən}-{civilian}-{innocent civilians ; civilian life}-{n. 平民，百姓； 市民； 文官； 民法学者|adj. 民用的； 平民的；|,|\
ˌsɪvəlaɪˈzeɪʃn|ˌsɪvələˈzeɪʃn}-{civilization}-{our advanced state of civilization}-{n. 文明，文化； 开化，教化； 修养； 文明社会|,|\
ˈsɪvəlaɪz|ˈsɪvəˌlaɪz}-{civilize}-{The missionaries went out to civilize other places.}-{vt. 使文明； 使开化； 教化； 启发|vi. 变得文明；|,|\
klæp|klæp}-{clap}-{clap me on the shoulder.}-{vt.& vi. 拍手，鼓掌； 轻轻拍打某人； 急速放置； 振翼，拍翅膀|n. 鼓掌，拍手； 拍手声； 噼拍声； 破裂声|vi. 鼓掌，拍手； 啪地关上；|,|\
klæʃ|klæʃ}-{clash}-{Troops clashed near the border. ;clash between/with}-{vt. 发出撞击声；|vi. 争论； 不合； 交锋； 撞击出刺耳的响声|n. 冲突； 不协调； 撞击声；|,|\
ˌklæsɪfɪˈkeɪʃn|ˌklæsəfɪˈkeʃən}-{classification}-{There are five job classifications.}-{n. 分类； 分级； 类别； （动植物等的）分类学|,|\
ˈklæsɪfaɪ|ˈklæsəˌfaɪ}-{classify}-{classify something as/under something}-{vt. 分类，归类； 把…列为密件；|,|\
klɔ:|klɔ}-{claw}-{get your claws into somebody}-{n. （动物的）爪； （蟹等的）钳； 爪形器具；|vt.& vi. 用爪抓（或挖）；|,|\
kleɪ|kle}-{clay}-{made of clay}-{n. 黏土，泥土； （相对于灵魂而言的）人体，肉体； 似黏土的东西； 克莱（男子名， Clayton 的昵称）|vt. 用黏土处理；|,|\
klɪf|klɪf}-{cliff}-{The car rolled over the edge of a cliff}-{n. 悬崖，峭壁；|,|\
klɪŋ|klɪŋ}-{cling}-{cling to/on/at etc}-{vi. 附着于，紧贴； 抓紧或抱住； 坚持； 沿（岸）前进，贴着（墙）走|vt. 依恋，依附于；|,|\
ˈklʌmzi|ˈklʌmzi}-{clumsy}-{clumsy scissors clumsy wooden shoes}-{adj. 笨拙的； 复杂难懂的； 得罪人的； （文体等）臃肿的|,|\
}-{co}-{.}-{abbr. Colombia 哥伦比亚； Cash Order 现付票； Certificate of Origin 货源证书；|,|\
kɔ:s|kɔrs}-{coarse}-{coarse salt coarse skin}-{adj. 粗鄙的； 粗糙的； 粗野的； 粗制滥造的|,|\
ˈkɒgnətɪv|ˈkɑgnətɪv}-{cognitive}-{cognition recognition;cognitive psychology}-{adj. 认知的； 认识的；|,|\
kɔɪl|kɔɪl}-{coil}-{The snake coiled(itself) up round the branch.}-{n. （一）卷，（一）盘； 盘卷之物； 线圈； 纷乱，纠缠不清|vt. 盘绕； 卷成一圈；|vi. 绕成盘状； 卷绕成圈；|,|\
kəˈlektɪv|kəˈlɛktɪv}-{collective}-{a collective action}-{adj. 集体的； 共同的； 集合的； 集体主义的|n. [统]集体； [语]集合名词； 集团；|,|\
kəˈlɪʒn|kəˈlɪʒən}-{collision}-{a collision with a truck.collide}-{n. 碰撞； 冲突； （意见，看法）的抵触； （政党等的）倾轧|,|\
ˈkɒləni|ˈkɑləni}-{colony}-{Algeria was formerly a French colony.}-{n. 殖民地； 聚居地； 群体； 聚居人群|,|\
kəʊm|koʊm}-{comb}-{Police are still combing the woods for the missing boy.}-{n. 梳子； 梳棉机； 鸡冠状的东西； 蜂窝状的东西|vt. 梳理； 彻底搜查；|vi. 涌起，卷起；|,|\
ˈkɒmbæt|ˈkɑmbæt}-{combat}-{unarmed combat ;combat inflation/crime/racism etc}-{n. 格斗，搏斗，战斗； 〈美〉竞赛，比赛； 论战；|vt. 与…战斗； 与…斗争； 防止； 减轻|,|\
ˈkɒmədi|ˈkɑmədi}-{comedy}-{comedy writer/series/show/actor etc}-{n. 喜剧； 喜剧性； 喜剧体裁； 有趣的事情|,|\
kəˈmɑ:ndə(r)|kəˈmændə(r)}-{commander}-{The commander had been released.}-{n. 指挥官，司令官； [海]中校，副舰长； 木槌；|,|\
ˈkɒmɜ:s|ˈkɑmɜrs}-{commerce}-{local commerce and industry}-{n. 商业； 商务； 贸易；|,|\
kəmˈpæniən|kəmˈpænjən}-{companion}-{closest companion .}-{n. 同伴； [天]伴星(=~star)； （用于书名）指南； 同甘共苦的伙伴|vt. 同行； 陪伴；|,|\
ˈkɒmpərəbl|ˈkɑmpərəbl}-{comparable}-{compare;The planet Pluto is comparable in size to the Moon.}-{adj. 可比较的； 比得上的；|,|\
kəmˈpærətɪv|kəmˈpærətɪv}-{comparative}-{comparative comfort/freedom/wealth ;comparative study/analysis}-{adj. 比较（上）的； 按比较估计的； 相当的，还可以的；|n. [语]（形容词或副词的）比较级形式； 可匹敌者，可比拟物；|,|\
ˈkʌmpəs|ˈkʌmpəs, ˈkɑm-}-{compass}-{a map and compass}-{n. 罗盘； 指南针； 圆规； 界限|,|\
kəmˈpel|kəmˈpɛl}-{compel}-{compel somebody to do something}-{vt. 强迫，迫使； 强制发生，使不得不；|,|\
ˈkɒmpɪtənt|ˈkɑmpɪtənt}-{competent}-{very/highly/extremely competent to do sth}-{adj. 有能力的，能胜任的； 能干的，称职的； 足够的，充足的； 有决定权的|,|\
kəmˈpəʊz|kəmˈpoʊz}-{compose}-{Water is composed of hydrogen and oxygen. ;compose a letter/poem/speech etc}-{vt. 组成，构成； 调解； [印刷]排（字）； 使安定|vt.& vi. 创作（乐曲、诗歌等）； 为…谱曲；|vi. 构图，构成；|,|\
ˌkɒmprɪˈhenʃn|ˌkɑmprɪˈhenʃn}-{comprehension}-{beyond my comprehension}-{n. 理解，理解力； 包含的能力； [逻辑学]内涵；|,|\
kəmˈpres|kəmˈprɛs}-{compress}-{compress sth into sth}-{vt. 压紧； 压缩； 精简；|n. 止血敷布； 打包机；|,|\
ˈkɒmprəmaɪz|ˈkɑmprəmaɪz}-{compromise}-{a compromise between ...and;she was unable to compromise on (with);back down}-{n. 妥协； （名誉等的）损害； 妥协（或折中）方案； 折中物|vi. 折中解决； 妥协，退让；|vt. 违背（原则）； 连累； （尤指因行为不很明智）使陷入危险；|,|\
kənˈsi:l|kənˈsil}-{conceal}-{conceal sb/sth from been seen}-{vt. 隐藏，隐瞒，遮住；|,|\
kənˈsi:d|kənˈsid}-{concede}-{concede defeat ;concede sth to sb}-{v. 承认； 让步，容许； 承让；|,|\
kənˈseʃn|kənˈsɛʃən}-{concession}-{make concessions to sb;adj. concessive}-{n. 让步，迁就； （尤指由政府或雇主给予的）特许权； 租借地； 承认或允许|,|\
kənˈsaɪs|kənˈsaɪs}-{concise}-{a concise summary}-{adj. 简明的，简洁的； ； 简约； 精炼|,|\
ˈkɒŋkri:t|ˈkɑŋkrit}-{concrete}-{concrete evidence ;the concrete of a wall}-{adj. 具体的，有形的，实在的，实际的； 固结成的，混凝土制的； 图案诗歌的；|n. 混凝土； 具体物； （图案式）有形诗； 〔建〕钢筋混凝土|vt. 使凝固； 用混凝土修筑； 萃取；|vi. 凝固； 固结； 变坚固； 使用混凝土|,|\
kənˈdem|kənˈdɛm}-{condemn}-{condemn something/somebody as something ;condemn to death .}-{vt. （通常因道义上的原因而）谴责； 宣判； 宣布…不能使用； 迫使…陷于不幸的境地|,|\
kənˈdens|kənˈdɛns}-{condense}-{condense something into something;adj. dense}-{v. （使）冷凝； （使）凝结； 精简； 压缩|,|\
kənˈdʌktə(r)|kənˈdʌktɚ}-{conductor}-{Wood is a poor conductor of heat.}-{n. <电>导体； 售票员； （乐队）指挥； 导管（套管的一种）|,|\
kənˈfes|kənˈfɛs}-{confess}-{He confessed to having a secret admiration for his opponent. ;I (have to/must) confess}-{v. 供认； 坦白； 承认； 悔过|,|\
kənˈfrʌnt|kənˈfrʌnt}-{confront}-{be confronted with something ;confront somebody with/about something}-{vt. 面对； 使面对面，使对质； 碰到，遇到； 比较|,|\
kənˈfju:z|kənˈfjuz}-{confuse}-{confuse somebody/something with somebody/something}-{vt. 使困窘； 使混乱； 使困惑； 使更难于理解|vi. 使糊涂；|,|\
kənˈgrætʃuleɪt}-{congratulate}-{congratulate somebody on something}-{vt. 向（某人）道贺； 祝贺； （为成就或成功）感到高兴；|,|\
ˈkɒŋgres|ˈkɑŋgrəs}-{congress}-{National People's Congress}-{n. 国会； 代表大会； （用于某些国家的政党名称）国民大会； 社交|vi. 开会，集合；|,|\
kənˈdʒʌŋkʃn|kənˈdʒʌŋkʃən}-{conjunction}-{conjunct adj.结合的, 共同的n.与他人联合的, 同他物结合的物a happy conjunction of events}-{n. 连词； 连接； 联合，结合物； （恒星、行星等的）合|,|\
ˈkɒŋkə(r)|ˈkɑŋkə(r)}-{conquer}-{conquer your nerves/fear;subdue;subjugate;vanquish}-{vt. 征服； 攻克； 打败（敌人）； 克服|vi. 得胜，胜利；|,|\
ˈkɒŋkwest|ˈkɑŋkwest}-{conquest}-{French conquests in Asia}-{n. 征服，击败； 战利品； （尤指）爱情的俘虏； 赢得（物）|,|\
ˈkɒnʃəns|ˈkɑnʃəns}-{conscience}-{a guilty/troubled conscience}-{n. 良心； 道德心；|,|\
ˌkɒnsəˈveɪʃn|ˌkɑnsərˈveɪʃn}-{conservation}-{a local conservation group ;energy conservation}-{n. 保存； 保护； 避免浪费； 对自然环境的保护|,|\
kənˈsɜ:vətɪv|kənˈsɜrvətɪv}-{conservative}-{a very conservative attitude to education}-{n. 保守的人； （英国）保守党党员，保守党支持者；|adj. 保守的； （英国）保守党的； （式样等）不时新的；|,|\
kənˈsɪdərət|kənˈsɪdərɪt}-{considerate}-{a considerate person, act, attitude}-{adj. 体贴的，体谅的； 深思熟虑； 到； 慎重|,|\
kən'səʊl|kənˈsoʊl}-{console}-{condole;console yourself with something}-{vt. 安慰，慰问；|n. 控制台，操纵台； 演奏台； 悬臂； 肘托|,|\
kənˈteɪnə(r)|kənˈtenɚ}-{container}-{ice cream in plastic containers}-{n. 容器； 箱，匣； 集装箱，货柜；|,|\
kənˈtɪnjuəm|kənˈtɪnjuəm}-{continuum}-{All the organisms in an ecosystem are part of an evolutionary continuum.}-{n. [数]连续统； [经]连续统一体； 闭联集； [物]连续区|,|\
kənˈvi:niəns|kənˈvinjəns}-{convenience}-{the convenience of doing something ;at (for) sb’s convenience}-{n. 方便，便利； 便利设施； 个人的舒适或利益； （公共）厕所|,|\
kənˈveɪ|kənˈve}-{convey}-{convey a sense/an impression/an idea etc ;convey something to somebody}-{vt. 传达，传递； 运送，输送； [法]让与，转让（财产等）； 表达|,|\
kənˈveɪəns|kənˈveəns}-{conveyance}-{the conveyance of goods}-{n. 传送； 运送； 表达； <正>运输工具|,|\
kənˈvɪkt|kənˈvɪkt}-{convict}-{convict sb of fraud}-{vt. 宣判有罪； 证明…有罪； 使知罪； 定…的罪|n. 罪犯；|,|\
kɒp|kɑp}-{cop}-{a cop with a dog}-{n. 〈俚〉警察； 管纱； 〈英方〉（山）顶；|vt. 偷盗； 抓住，获得； 取走；|,|\
ˈkɒpə(r)|ˈkɑpə(r)}-{copper}-{largest producer of copper;I ,as a copper;}-{n. 铜； 铜币； 紫铜色； 警察|adj. 铜制的；|vt. 镀铜；|,|\
ˈkɒpiraɪt|ˈkɑpiraɪt}-{copyright}-{copyright reserved;copyright information}-{n. 版权，著作权；|adj. 受版权保护的； 版权的；|vt. 获得…的版权；|,|\
ˈkɒrəl|ˈkɔrəl}-{coral}-{compensation for coral ruined}-{n. 珊瑚； 珊瑚虫； 珊瑚色； 龙虾卵|adj. 珊瑚的； 珊瑚色的；|,|\
kɔ:d|kɔrd}-{cord}-{tied with cord;guy;hawser}-{n. （细）绳； 灯心绒裤；|vt. 用绳子捆绑； 堆积（柴薪）；|,|\
ˈkɔ:dləs|ˈkɔrdləs}-{cordless}-{a cordless phone}-{adj. （电话或电动工具）不用电线与电源相连的，无电线的，无塞绳式的；|,|\
kəˈrekʃn|kəˈrɛkʃən}-{correction}-{make a few corrections}-{n. 修改； 改[纠]正； 惩罚； 有待改正|adj. 改正的，纠正的；|,|\
ˌkɒrəˈspɒndənt|ˌkɔrəˈspɑndənt}-{correspondent}-{political/foreign/legal etc correspondent}-{n. 通讯员，记者； 通信者；|,|\
ˈkɒstli|ˈkɔstli}-{costly}-{a costly mistake}-{adj. 昂贵的； 代价高的；|,|\
ˈkɒstju:m|ˈkɑstum}-{costume}-{a costume play}-{n. （戏剧或电影的）戏装，演出服； 服装，衣服； 泳装，常用于英式英语； （某地或某历史时期的）服装|vt. 给…穿上服装； 给…提供服装；|,|\
kɒf|kɔf}-{cough}-{You must go to the doctor if you’re coughing up blood.}-{vt.& vi. 咳嗽； （引擎等）发噗噗声； 咳出；|n. 咳，咳嗽； 咳嗽病； （机关枪等的）连续发射声；|,|\
ˈkaʊnsl|ˈkaʊnsəl}-{counsel}-{wise counsel;She counselled them not to accept this settlement.}-{n. 协商，讨论； 建议； 策略； 法律顾问，辩护人|vt. 劝告，建议； 提供专业咨询；|,|\
ˈkɜ:təsi|ˈkɜrtəsi}-{courtesy}-{At least do me the courtesy of telling the truth.}-{n. 谦恭有礼，礼貌，请安； 有礼貌的举止[言词]； 承蒙；|adj. 殷勤的； 出于礼节的；|,|\
ˈkɔ:tjɑ:d|ˈkɔrtjɑrd}-{courtyard}-{the cobbled courtyard}-{n. 庭院，院子； 天井；|,|\
ˈkʌvərɪdʒ|ˈkʌvərɪdʒ}-{coverage}-{media/press etc coverage}-{n. 范围，规模； 保险项目； （新闻）报导； [植]优势度|,|\
ˈkaʊbɔɪ|ˈkaʊˌbɔɪ}-{cowboy}-{a cowboy on a ranch}-{n. 牛仔； 牧童； 富有冒险精神的英雄； [俚语]莽撞的人|,|\
kreɪn|kren}-{crane}-{hoist}-{n. 吊车，起重机； 鹤；|vt.& vi. 伸长，探头；|vi. 迟疑，踌躇；|,|\
krɔ:l|krɔl}-{crawl}-{crawl along/across etc ;The floor was crawling with ants.}-{vi. 爬行； 缓慢行进； 巴结；|n. 缓慢的爬行； 〈美俚〉跳舞，自由式游泳； 养鱼（龟）池；|,|\
kri:p|krip}-{creep}-{creep up sth climb creep into sth}-{vi. 爬行，匍匐； 缓慢地行进；|n. 爬行，蠕动； 虫爬着似的感觉，毛骨悚然； 卑鄙小人，谄媚者；|,|\
ˈkrɪkɪt|ˈkrɪkɪt}-{cricket}-{a cricket bat;He angrily stomped his cricket}-{n. 蟋蟀； 板球； 矮木凳；|vi. 打板球；|adj. 公平的；|,|\
krɪtɪklɪ|ˈkrɪtɪklɪ}-{critically}-{This is a critically important meeting. ;Mike looked at her critically.}-{adv. 批判性地； 苛求地； 危急地； 严重地|,|\
ˈkrɒsɪŋ|ˈkrɔsɪŋ}-{crossing}-{You must give way to any pedestrians on the crossing.}-{n. 人行横道，十字路口； 交叉，相交； 横越； 渡口|v. 交叉(cross的现在分词)；|,|\
krəʊ|kroʊ}-{crow}-{He was crowing over winning the bet.}-{n. 乌鸦； 雄鸡的啼声；|vi. 公鸡啼鸣，报晓； 欢呼； （尤指在其他人不成功时）扬扬自得地夸口；|,|\
kru:d|krud}-{crude}-{crude rubber 橡胶}-{adj. 粗糙的，粗杂的； 粗鲁的； 天然的，未加工的； 简陋的|n. 原[生]材料，天然物质； 原油；|,|\
krʌʃ|krʌʃ}-{crush}-{crush a rebellion/uprising/revolt}-{vt. 压破，压碎； 镇压； 弄皱； 挤榨，榨出|vi. 挤； 被压碎，被起皱；|n. 粉碎，被压碎的状态； （特指女子对男性的）迷恋； 拥挤的人群； 果汁饮料|,|\
krʌst|krʌst}-{crust}-{carapace;Cut crusts off}-{n. 面包皮； 外壳； 硬外皮； 地壳|vt. 用外皮覆盖； 在…上结硬皮； 生痂儿；|vi. 结成外壳； 结硬皮；|,|\
ˈkrɪstl|ˈkrɪstəl}-{crystal}-{crystal ball}-{n. 结晶（体）； 晶体； 水晶； 水晶饰品|adj. 水晶的； 水晶般的； 透明的； 清楚的|,|\
kju:b|kjub}-{cube}-{an ice cube ;4 cubed is 64}-{n. 立方形，立方体； 立方，三次幂； 小房间；|vt. 求…的立方； 把（食物）切成小方块； 测定…的体积；|,|\
ˈkju:kʌmbə(r)|ˈkjuˌkʌmbɚ}-{cucumber}-{have some cucumber}-{n. 黄瓜，胡瓜；|,|\
kju:|kju}-{cue}-{take your cue from somebody ;Will you cue me on my lines}-{n. 暗示，提示； 线索； [台]球杆； 情绪，心情|vt. 把…插入演出； 给…暗示；|,|\
ˈkʌltɪveɪt|ˈkʌltəˌvet}-{cultivate}-{We cultivated maize and watermelons.}-{vt. 耕作，种植； 教养，栽培； 改善； 交朋友|,|\
ˈkju:mjələtɪv|ˈkjumjəleɪtɪv}-{cumulative}-{cumulative effect (of something)}-{adj. 累积的； 渐增的； 追加的； （判刑等）加重的|,|\
ˌkjʊəriˈɒsəti|ˌkjʊriˈɑsəti}-{curiosity}-{a natural curiosity about}-{n. 好奇心，爱打听的癖性； 奇人； 奇物，古玩； 奇特性|,|\
kɜ:l|kɜrl}-{curl}-{Mary was busy curling her hair.}-{n. 一绺鬈发； 卷曲物； 螺旋状物； （指头发）拳曲|vt.& vi. （使）弯曲； （使）卷曲； 盘旋； 缠绕|vt. 撅起嘴唇； 撇（嘴）； （使）呈螺旋（或卷曲）状移动； （使）旋绕|,|\
kəˈrɪkjələ(r)}-{curricular}-{curricular changes}-{adj. 课程的；|,|\
kɜ:s|kɜrs}-{curse}-{Noise is one of the curses of modern-day life. ;Elsa cursed herself for believing his lies.}-{vt.& vi. 诅咒； 咒骂； 使苦恼，使困苦； 把（某人）逐出教门|n. 诅咒； 咒语； 祸害，祸因； 咒逐，逐出教门|,|\
ˈdeəri|ˈderi}-{dairy}-{dairy products/produce}-{n. 牛奶场； 乳品店； 牛奶及乳品业；|adj. 牛奶的； 奶制的； 乳品的； 乳品业的|,|\
dæm|dæm}-{dam}-{Once she allowed her anger to show, it could not be dammed up again}-{n. 水坝，堰； 水库； （牙科用的）橡皮障； 〈比喻〉障碍|vt. 用水坝阻止； 阻塞，抑制；|,|\
dæm|dæm}-{damn}-{damn (somebody/something) with faint praise}-{adv. 非常； （表示厌烦）该死； 讨厌； 十足|vt. 诅咒； 谴责，指责； 使…失败； [永世受罚，定罪|vi. 诅咒； 咒骂；|n. 一点也不，丝毫；|adj. 该死的； （表示厌烦）可恶的；|,|\
dæmp|dæmp}-{damp}-{damp clothes;damp something ↔ down}-{adj. 微湿的，潮湿的； 消沉的，沮丧的； 沉闷的； 情绪低落的|n. 潮湿； 消沉，失望； 矿井瓦斯； 有毒气体|vt. 使潮湿； 使泄气，使沮丧； 抑制，阻抑； 使减弱|vi. [物]阻尼； 减幅；|,|\
dæʃ|dæʃ}-{dash}-{The ship was dashed against the rocks. ;A dash of something ;}-{vi. 猛冲； 赶紧离开；|vt. 猛撞； 匆忙完成； 泼溅； 使…破灭|n. 少量，些许； 猛冲； 破折号； 短跑|,|\
ˈdeɪlaɪt|ˈdeˌlaɪt}-{daylight}-{during daylight hours .}-{n. 日光，白昼； 清早，黎明； 公开，发表； <俚>眼睛，视力|,|\
ˈdedlaɪn|ˈdɛdˌlaɪn}-{deadline}-{He missed the deadline for applications. ;set/impose a deadline}-{n. 最后期限； 截止期限； 死线； 原稿截止时间|vt. 通过设定一时间期限来统治；|,|\
ˈdedli|ˈdɛdli}-{deadly}-{deadly disease/virus}-{adj. 极端的，非常的； 致命的，致死的； 非常有效的； 如死一般的|adv. 极其，非常； 死了一样地；|,|\
dɪˈkeɪ|dɪˈke}-{decay}-{Her body was already starting to decay.}-{vt.& vi. （使）腐烂，腐朽；|vi. 衰败，衰退，衰落；|n. 腐败、衰退的状态；|,|\
dɪˈsi:v|dɪˈsiv}-{deceive}-{deceive somebody into doing something}-{v. 欺诈； 误导；|,|\
dɪˈsaɪsɪv|dɪˈsaɪsɪv}-{decisive}-{a decisive victory, battle, moment}-{adj. 决定性的； 坚定的； 果断的，决断的；|,|\
dek|dɛk}-{deck}-{above/below deck ;The street was decked with flags for the royal wedding.}-{n. 甲板，舱板； [建]平屋顶，桥面； [铁路]客车车顶； 〈俚〉地面|vt. 装饰； 给…铺上甲板； 打扮；|,|\
ˌdekləˈreɪʃn|ˌdɛkləˈreʃən}-{declaration}-{the declaration of war}-{n. 宣言，布告，公告，声明； （纳税品在海关的）申报； [法]（原告的）申诉，（证人的）陈述，口供； [牌]摊牌，叫牌|,|\
ˈdekəreɪt|ˈdɛkəˌret}-{decorate}-{decorate something with something}-{vt. 装饰； 点缀； 粉刷； 授予（某人）勋章|vi. 装饰； 布置；|,|\
dɪˈkri:s|dɪˈkris}-{decrease}-{decrease in frequency ;a steady decrease of}-{n. 减少，减小； 减少量；|vi.&vt. 减少，减小；|,|\
ˈdi:fekt|ˈdiˌfɛkt, dɪˈfɛkt}-{defect}-{a genetic defect ;a Russian actor who defected to the West}-{n. 瑕疵，毛病； 欠缺，缺点；|vi. 叛逃； 背叛；|,|\
dɪˈfɪʃnsi|dɪˈfɪʃənsi}-{deficiency}-{a deficiency of safe play areas for children}-{n. 缺乏，不足； 缺点，缺陷； 不足额；|,|\
dɪˈfaɪ|dɪˈfaɪ}-{defy}-{I defy somebody to do something}-{vt. 不服从； 公然反抗； 蔑视； 向…挑战|n. 挑战； 对抗；|,|\
ˈdelɪgət|ˈdɛlɪˌɡet}-{delegate}-{Around 350 delegates ;Minor tasks should be delegated to your assistant.}-{n. 代表，代表团成员；|vt. 委派代表； 授权给； [法律]债务转移；|,|\
dɪˈli:t|diˈlit}-{delete}-{His name was deleted from the list.}-{vt.& vi. 删除；|,|\
dɪˈlɪbərət|dɪˈlɪbərɪt}-{deliberate}-{deliberate steps. ;The jury deliberated for four days before acquitting him.}-{adj. 故意的； 蓄意的； 深思熟虑的； 慎重的|vt. 权衡；|vi. 熟虑； 商讨；|,|\
ˈdelɪkət|ˈdɛlɪkɪt}-{delicate}-{a child’s delicate skin .}-{adj. 微妙的； 熟练的； 纤弱的； 易损的|,|\
dɪˈlɪʃəs|dɪˈlɪʃəs}-{delicious}-{deliciously spicy meat}-{adj. 美味的，可口的； 有趣的； ； 喷香|,|\
dens|dɛns}-{dense}-{a dense population;dense fog/smoke/cloud}-{adj. 密集的，稠密的； 浓密的，浓厚的； 愚钝的；|,|\
ˈdensəti|ˈdɛnsɪti}-{density}-{the size and density of settlements}-{n. 密度； 稠密，浓厚； [物]浓度，比重； 愚钝|,|\
ˈdentl|ˈdɛntl}-{dental}-{dental work 与牙科有关的工作;dental treatment/care}-{adj. 牙齿的； 牙科的； （辅音）齿音的；|n. 齿音；|,|\
dɪˈpɑ:t|dɪˈpɑrt}-{depart}-{depart from the island ;his dear departed wife}-{v. 离开，出发； 去世； 离职； 脱轨|,|\
ˈdepjuti|ˈdɛpjəti}-{deputy}-{deputy director/chairman/governor etc}-{n. 副手； 代理人； 代表；|adj. 副的； 代理的；|,|\
dɪˈsend|dɪˈsɛnd}-{descend}-{descend from a ladder}-{v. 下来，下降 ； 下斜； 降临； 突然造访|,|\
dɪˈzaɪərəbl|dɪˈzaɪrəbəl}-{desirable}-{It is desirable that}-{adj. 令人满意的； 值得拥有的； 可取的； 性感的|n. 称心如意的人[东西]；|,|\
dɪˈspeə(r)|dɪˈsper}-{despair}-{the despair of somebody ;My teachers began to despair of me.}-{n. 绝望； 使人绝望的人（或事物）；|vi. 绝望；|,|\
dɪˈzɜ:t|dɪˈzɜrt}-{dessert}-{She had homemade ice cream for dessert}-{n. 餐后甜食； 甜点；|,|\
ˌdestɪˈneɪʃn|ˌdɛstəˈneʃən}-{destination}-{holiday/tourist destination}-{n. 目的，目标； 目的地，终点； [罕用语]预定，指定；|,|\
dɪˈstrʌktɪv|dɪˈstrʌktɪv}-{destructive}-{the destructive power of modern weapons}-{adj. 破坏性的； 毁灭性的； 有害的；|,|\
dɪˈvaɪz|dɪˈvaɪz}-{devise}-{She devised a method for}-{v. 设计； 发明； 策划； 想出|n. 遗赠； 遗赠的财产； 遗赠的条款；|,|\
ˈdaɪəlekt|ˈdaɪəˌlɛkt}-{dialect}-{the local dialect}-{n. 方言，土语； 语调； [语]语支； 专业用语|,|\
daɪˈæmɪtə(r)|daɪˈæmɪtɚ}-{diameter}-{six centimetres in diameter. ;The diameter of}-{n. 直径，直径长； 放大率；|,|\
dɪkˈteɪt|ˈdɪkteɪt}-{dictate}-{dictate a letter/memo etc to somebody ;dictate that}-{vt. 口述； 命令，指示； 使听写； 控制，支配|vi. 口述； 命令；|,|\
dɪkˈteɪʃn|dɪkˈteʃən}-{dictation}-{I hate doing French dictations .}-{n. 口授，听写； 听写测验； 命令；|,|\
daɪˈdʒest|daɪˈdʒest}-{digest}-{I struggled to digest the news.}-{vt.& vi. 消化； 整理；|vt. 吸收； 领悟； 玩味；|vi. 消化； 吸收食物； [化学]加热；|n. 文摘； 摘要； 法律汇编； 罗马法典|,|\
ˈdɪdʒɪtl|ˈdɪdʒɪtl}-{digital}-{a digital camera}-{adj. 数字的； 数据的； 手指的； 指状的|n. 手指； （钢琴等的）琴键； 数字；|,|\
ˈdɪlɪdʒənt|ˈdɪlədʒənt}-{diligent}-{be diligent into doing sth}-{adj. 勤奋的； 勤勉的； 用功的； 费尽心血的|,|\
dɪm|dɪm}-{dim}-{a dim room;Even the rain could not dim their enthusiasm.}-{adj. 暗淡的，昏暗的； 不光明的； 看不清的； （性质和特征上）不显著的|vt.& vi. （使）变暗淡； （使）变模糊； （使）减弱； 变淡漠|n. 笨蛋，傻子；|,|\
dɪp|dɪp}-{dip}-{dip sth into sth}-{vt. 浸； （把烛芯浸在融蜡里）制造（蜡烛）； 把（汽车前灯）的远光调为近光； 洗药水浴|vt.& vi. （使）微降，（使）下沉； （使）向下再向上；|n. 浏览； （通常指暂时的）减少； 洗澡； 倾斜|vi. 浸水； 提取； （轻度或暂时地）减少； 浏览|,|\
ˌdɪpləˈmætɪk|ˌdɪpləˈmætɪk}-{diplomatic}-{diplomatic relations ;a diplomatic answer}-{adj. 外交上的； 外交人员的； 有手腕的； 策略的|,|\
dɪˈzɑ:strəs|dɪˈzæstrəs}-{disastrous}-{disastrous effects/consequences/results ;The move proved disastrous}-{adj. 灾难性的； 损失惨重的； 极坏的； 悲惨的|,|\
dɪsˈkɑ:d|dɪsˈkɑrd}-{discard}-{discarded paper}-{vt. 丢弃，抛弃； 解雇； 出牌；|n. 被抛弃的人[物]； 丢弃，抛弃； 打出的牌； 打出的牌|vi. 出无用的牌； 垫牌；|,|\
dɪsˈtʃɑ:dʒ|dɪsˈtʃɑrdʒ}-{discharge}-{The judge discharged the jury. ;discharge into the river}-{vt. 下（客）； 卸船； 免除（自己的义务、负担等）； 执行|vt.& vi. 放出； 流出； 开枪； 发射|n. （气体、液体如水从管子里）流出； 排放出的物体；|vi. （船、飞机等）卸货； （颜料、墨水或染料等）化开； 卸掉负担（或负载）； 下客|,|\
dɪsˈkləʊz|dɪsˈkloʊz}-{disclose}-{He refused to disclose}-{vt. 公开； 揭露； 使显露； 使暴露|,|\
dɪsˈkʌrɪdʒ|dɪsˈkɜrɪdʒ}-{discourage}-{discourage somebody from doing something}-{vt. 使气馁； 使沮丧； 阻碍； 劝阻|,|\
dɪsˈgaɪz|dɪsˈɡaɪz}-{disguise}-{disguise yourself as somebody/something;=guise;双重的guise}-{vt. 隐瞒，掩饰； 伪装，假装； 化装； 掩盖|n. 伪装； 伪装品； 用作伪装的东西； 托辞，借口|,|\
dɪsˈgʌst|dɪsˈɡʌst}-{disgust}-{be disgusted to find/hear/see;his disgust at the incident;gust风味}-{n. 反感，厌恶，嫌恶；|vt. 使反感，厌恶；|,|\
dɪsˈɔ:də(r)|dɪsˈɔrdə(r)}-{disorder}-{a mental/psychiatric disorder ;}-{n. 混乱，凌乱； 动乱，骚乱； 不正当行为； （身心机能的）失调|vt. 使混乱，使凌乱； 扰乱； 使（身心等）失调； 使（神经等）错乱|,|\
dɪsˈpli:z|dɪsˈpliz}-{displease}-{He looked extremely displeased with sth}-{vt. 使生气，使不愉快； 冒犯，触怒；|vi. 使生气； 使不快；|,|\
dɪˈzɒlv|dɪˈzɑlv}-{dissolve}-{dissolve the salt in water;She dissolved into fits of laughter.}-{vt. 使溶解； 使（固态物）溶解为液体，使液化； 使消失，使消逝，消除； 使终止|vi. 溶解； 融化，液化； 解散，散去； 分裂，分解|,|\
dɪˈstres|dɪˈstrɛs}-{distress}-{The dream had distressed her greatly. ;in distress}-{n. 悲痛； 危难，不幸； 贫困； [法]扣押财物|vt. 使痛苦，使忧伤； [法]扣押（财物）； 使贫困；|,|\
dɪˈstɜ:bəns|dɪˈstɜrbəns}-{disturbance}-{create/cause a disturbance}-{n. 打扰； 骚乱，变乱； 困扰； 烦闷|,|\
dɪtʃ|dɪtʃ}-{ditch}-{last-ditch ;the deep ditch}-{n. 沟渠； 壕沟；|vt. 摆脱，抛弃； 在…上掘沟； 把…开入沟里； 使（火车）出轨|vi. 使（飞机）在海上紧急降落，（在海上）迫降； 开沟；|,|\
daɪv|daɪv}-{dive}-{She dived into a pool. ;The dollar dived against the yen in Tokyo today.}-{vi. 潜水； 跳水； 急剧下降； （头朝下）跳入水中|n. 潜水； 跳水； 俯冲，（潜艇）下潜； （气温，股价等的）暴跌，跳水|vt.& vi. 突然下降，暴跌；|,|\
dɪˈvaɪn|dɪˈvaɪn}-{divine}-{divine intervention/providence/revelation/guidance etc;divinely}-{adj. 神的， 天赐的； 极好的； 神圣的；|vt.&vi. 占卜，预言； 猜测， 预测； （用丫形杖）探测（地下水）；|n. 牧师； 神学家；|,|\
dɒk|dɑk}-{dock}-{Three defendants stood in the dock. ;dock sb’s wages/pay/salary}-{n. 码头； 被告席； 草本植物； 尾巴的骨肉部份|vt.& vi. （使）船停靠码头； 剪短（尾巴等）； 削减，缩减（工资等）； 在…设置船坞|vi. 入船坞；|,|\
dəʊˈneɪʃn|doʊˈneɪʃn}-{donation}-{blood/organ donation ; make a donation to}-{n. 捐赠，赠送； 捐款； 捐赠物；|,|\
ˈdɒŋki|ˈdɑŋki}-{donkey}-{(=donkey engine)轻便发动机 (=donkey pump)辅助泵}-{n. 驴，毛驴； 笨蛋，傻瓜； （美国）民主党的象征；|,|\
dɔ:m|dɔrm}-{dorm}-{dormitory}-{n. 宿舍；|,|\
ˈdɔ:mətri|ˈdɔrmətɔri}-{dormitory}-{a college dormitory}-{n. （学校等的）宿舍； 集体寝室； （在市内工作的人的）郊外住宅区；|adj. 住宅区的；|,|\
dəʊs|doʊs}-{dose}-{lethal/fatal dose (of something) ;Sumi dosed herself up with aspirin and went to bed.}-{n. 剂量，药量； （药的）一服，一剂； （处罚等）一回，一次，一番； （酒中的）配料，增味剂|vi. 服药；|vt. 给药； 给…服药； 把（药等）配分剂量； 在（酒）中加料|,|\
ˈdaʊtfl|ˈdaʊtfəl}-{doubtful}-{doubtful about (doing) something}-{adj. 难以预测的； 难以预料的，未定局的； 怀疑的，拿不准的； 不明不白|,|\
ˈdaʊnwəd|ˈdaʊnwərd}-{downward}-{a gentle downward slope}-{adj. 向下的，往下的；|adv. 向下地，下行地；|,|\
ˈdrægən|ˈdræɡən}-{dragon}-{like a dragon;dragon boat}-{n. 龙，龙船； [D-][天文学]天龙（星座）； [口语、贬义]脾气暴躁的人；|,|\
dreɪn|dren}-{drain}-{drain of reserve 外汇储备外流 drain...of;drain away/off/from}-{vi. 排水； 流干；|vt. 喝光，喝干； 使（精力、金钱等）耗尽； 使流出； 排掉水|n. 排水； 下水道； 排水系统； [医]引流|,|\
drɪft|drɪft}-{drift}-{drift out/towards etc}-{vi. 流动； 随意移动； 漂泊； 浮现|vt. 漂流； 堆积成堆；|n. 漂移，偏移； 趋势，动向； 大意； 放任自流|,|\
drɪl|drɪl}-{drill}-{an electric drill ;The sergeant was drilling the new recruits.}-{n. 操练； 钻头； 军事训练； （应对紧急情况的）演习|vt.& vi. 钻（孔）； 打（眼）； 操练； 训练|vt. 作…演习，操练；|,|\
drɪp|drɪp}-{drip}-{be dripping with blood/sweat etc ;Drips of water}-{vt.& vi. （使）滴下；|vi. 滴出； 含有； 充满； 充溢|n. 滴答，滴答滴答的声音； 水滴； [医]点滴； 点滴（的信息等）|,|\
drʌm|drʌm}-{drum}-{He was drummed out of the army.}-{n. 鼓； 鼓状物； 鼓声； 石首鱼|vt. 击鼓； 连打； 反复讲； 鼓吹|vi. 击鼓； 连打； 拍翅；|,|\
ˈdjʊərəbl|ˈdʊrəbl}-{durable}-{a durable peace, friendship, settlement}-{adj. 耐用的，耐久的； 持久的； 长期的；|n. 耐用品，耐久品；|,|\
dʌsk|dʌsk}-{dusk}-{The street lights go on at dusk.}-{n. 黄昏，傍晚； 幽暗；|adj. 微暗的； 变暗的； 〈诗〉同dusky；|v. 变暗； 使变暗；|,|\
daɪ|daɪ}-{dye}-{hair dye ;dye something black/blue/blonde etc}-{n. 染料，染色； 颜色；|vt. 染色； 给…染色；|vi. 染上或粘上（颜色）；|,|\
ˈdaɪɪŋ|ˈdaɪɪŋ}-{dying}-{dying moment/minutes/seconds ; dying wish}-{adj. <口>渴望，切盼； 垂死的，临终的； 会死的； 快熄灭的|v. “die”的现在分词；|,|\
ˈi:gə(r)|ˈiɡɚ}-{eager}-{eager to do something}-{adj. 渴望的； 热切的，热情洋溢的； 热心的； 急切|,|\
ˈi:gl|ˈiɡəl}-{eagle}-{eagle eye ;}-{n. 鹰； 鹰状标志； [高]比标准杆少两杆的分数；|v. [高]低于标准杆数两杆；|,|\
ˈɜ:nɪst|ˈɜrnɪst}-{earnest}-{earnest expression/look/voice etc ; be in dead/deadly/complete earnest}-{adj. 热心的； 诚挚的，真挚的； 重要的；|n. 热心； 认真； 定钱，保证金； 诚挚|,|\
ˈɜ:θkweɪk|ˈɜrθkweɪk}-{earthquake}-{in an earthquake zone.}-{n. 地震； 大变动； 动乱；|,|\
ˈekəʊ|ˈekoʊ}-{echo}-{This idea finds an echo in many African countries. ;The sound of an engine echoed back from the thick forest.}-{n. 回声，共鸣； （言语、作风、思想等的）重复； 重复者； [无线电]回波|vt. 重复，效仿； 随声附和； 类似； 发射（声音等）|vi. 被重复； 产生回响； 充满回声；|,|\
ˈedʒukeɪt|ˈɛdʒəˌket}-{educate}-{educate somebody about/in/on something}-{vt.& vi. 教育，教导； 训练，培养；|vt. 使理解或接受；|,|\
ɪˈlæbərət|ɪˈlæbəret}-{elaborate}-{silks with elaborate patterns ;McDonald refused to elaborate on his reasons for resigning.}-{vi. 详尽说明； 变得复杂；|vt. 详细制定； 详尽阐述； [生理学]加工； 尽心竭力地做|,|\
ɪˈlæstɪk|ɪˈlæstɪk}-{elastic}-{a bra乳罩 with elastic straps an elastic band}-{adj. 有弹力的； 可伸缩的； 灵活的；|n. 松紧带，橡皮圈；|,|\
ˈelbəʊ|ˈelboʊ}-{elbow}-{He elbowed his way to the bar and ordered a beer.}-{n. 肘部； 弯头，扶手； 肘形管，弯管；|vt. 用肘推挤（另一人或另一些人）； 用手肘推开；|vi. 用肘推搡着前进； 在拐角处转弯；|,|\
ɪˈlektrɒn|ɪˈlektrɑn}-{electron}-{proton , neutron}-{n. 电子；|,|\
ˈelɪgənt|ˈɛlɪɡənt}-{elegant}-{a tall, elegant young woman}-{adj. （人或其举止）优美的； 漂亮的； 简炼的； 简洁的|,|\
ˌelɪˈmentl|ˌɛləˈmɛntl}-{elemental}-{elemental human emotions.}-{adj. 基本的，主要的； 自然力的； [化]元素的； 强大的，可怕的|n. （古希腊）四元素的精灵； 基本原理；|,|\
ˌelɪˈmentri|ˌɛləˈmɛntəri, -tri}-{elementary}-{You’ve made a very elementary mistake. ;elementary education}-{adj. 基本的； 初级的； [化]元素的； 初等|,|\
ɪmˈbærəs|ɛmˈbærəs}-{embarrass}-{embarrass her by asking questions.}-{vt.& vi. （使）窘迫，（使）局促不安； （使）困难；|,|\
ˈembəsi|ˈɛmbəsi}-{embassy}-{the American Embassy in Paris}-{n. 大使馆； 大使馆全体成员； 大使的职务（地位）； 重任，差使|,|\
ɪmˈbɒdi|ɪmˈbɑdi}-{embody}-{She embodies everything I admire in a teacher.}-{vt. 表现，象征； 包含，收录； 使具体化； [军]组编|,|\
ɪmˈbreɪs|ɛmˈbres}-{embrace}-{Jack warmly embraced his son.}-{vt.& vi. 拥抱；|vt. 包括； 包含； 接受； 信奉|n. 拥抱，怀抱；|,|\
iˈmɪʃn|ɪˈmɪʃən}-{emission}-{Britain agreed to cut emissions of nitrogen oxide from power stations.}-{n. 排放，辐射； 排放物，散发物（尤指气体）； （书刊）发行，发布（通知）；|,|\
iˈmɪt|ɪˈmɪt}-{emit}-{emit an opinion.}-{vt. 发出； 发射； 颁布； 发表|,|\
ˈempərə(r)|ˈɛmpəɚ}-{emperor}-{the emperor of Japan.}-{n. 皇帝，君主；|,|\
ɪnˈkləʊz|ɪnˈkloʊz}-{enclose}-{Please find enclosed an agenda for the meeting. ;Please enclose a cheque with your order.}-{vt. （用墙、篱笆等）把…围起来； 把…装入信封； 附入；|,|\
ɪnˈdeɪndʒə(r)|ɛnˈdendʒɚ}-{endanger}-{Smoking during pregnancy endangers your baby’s life .}-{vt. 危及，使遭受危险；|,|\
ˈendɪŋ|ˈɛndɪŋ}-{ending}-{happy/perfect/surprise etc ending}-{n. 结局； 结束； 终结； 最后部份|v. 结束，终止(end的现在分词)；|,|\
ˈendləs|ˈɛndlɪs}-{endless}-{an endless stream of visitors}-{adj. 无尽的，无边的； 没完没了的； 永久的； 环形的，无端的|,|\
ɪnˈdjʊərəns|ɪnˈdʊrəns}-{endurance}-{physical/mental endurance}-{n. 耐久（力），持久（力）； 忍耐，忍耐力；|,|\
ɪnˈdjʊə(r)|ɪnˈdʊr}-{endure}-{He can’t endure being apart from me.}-{vt. 忍耐； 容忍；|vi. 持续，持久； 忍耐；|,|\
ɪnˈgeɪdʒmənt|ɛnˈɡedʒmənt}-{engagement}-{Their engagement was announced in the paper.}-{n. 订婚，婚约； 约会； 约定，契约； 雇用|,|\
ɪnˈlɑ:dʒ|ɪnˈlɑrdʒ}-{enlarge}-{enlarge sb’s understanding/knowledge}-{vt.& vi. 扩大，放大； 扩展，扩充； 拉长说，详述；|,|\
ɪnˈlaɪtn|ɛnˈlaɪtn}-{enlighten}-{lighten enlighten sb on sth}-{vt. 启发，启蒙； 开导，教导； 〈古〉照耀；|,|\
ɪnˈkwaɪə(r)|ɛnˈkwaɪr}-{enquire}-{inquire}-{vi. 打听；  询问； 问问题； 查问|,|\
ɪnˈrɪtʃ|ɛnˈrɪtʃ}-{enrich}-{enrich the power of expression;Education can greatly enrich your life .}-{vt. 使富裕，使富有； 给…添加肥料； 使…美味； 装饰|,|\
ˌentəˈteɪn|ˌentərˈteɪn}-{entertain}-{entertain somebody with something}-{vt. 热情款待； 使有兴趣； 抱着，怀有； 考虑|vi. 热情款待；|,|\
ˈenvi|ˈɛnvi}-{envy}-{envy of sb/sth;He envied Rosalind her youth and strength.}-{n. 嫉妒，妒忌； 羡慕；|vi. 感到妒忌； 显示出妒忌；|,|\
ˈepɪsəʊd|ˈepɪsoʊd}-{episode}-{the first episode of a new drama series}-{n. 插曲； 片段； 一集； 一段经历|,|\
iˈkwɒləti|iˈkwɑləti}-{equality}-{racial/sexual equality}-{n. 同等，平等； [数]相等，等式；|,|\
ɪˈkweɪtə(r)|ɪˈkwetɚ}-{equator}-{on/at/near the equator}-{n. 赤道； （平分球形物体的面的）圆； （任何）大圆；|,|\
ɪˈrekt|ɪˈrɛkt}-{erect}-{stand erect;It took a couple of hours to erect the tent.}-{vt. 使直立，使竖起； 建立，创立； 安装； [医]使勃起|adj. 直立的，垂直的； （头、手等）朝上举的； 直竖的； [医]勃起的|,|\
ˈesns|ˈɛsəns}-{essence}-{the essence of}-{n. 本质，实质； 精华，精髓； 香精；|,|\
ɪˈtɜ:nl|ɪˈtɜrnl}-{eternal}-{eternal love}-{adj. 永恒的，永久的； 似乎不停的，没完没了的； 不朽的； 永生的|n. 永恒的事物； Eternal 上帝，与定冠词the 连用；|,|\
i:v|iv}-{eve}-{on the eve of the election}-{n. 前夕，前夜； 重要事件的前夕； 傍晚；|,|\
ˈi:vnli|ˈivənlɪ}-{evenly}-{Spread the butter evenly over the toast.}-{adv. 平坦地； 均匀地； 淡然地； 不卑不亢地|,|\
ˌevəˈlɑ:stɪŋ|ˌevərˈlæstɪŋ}-{everlasting}-{last;a symbol of God’s everlasting love}-{adj. 永久的，永恒的，接连不断； 不断的，冗长的，使人厌烦的； [植]干后花的形状颜色不变的；|n. 永久，无穷； 〈英〉牢固耐久的毛呢； [植]蜡菊，蝶须，鼠曲草；|,|\
ɪgˈzædʒəreɪt|ɪgˈzædʒəreɪt}-{exaggerate}-{it’s easy/difficult/impossible to exaggerate something}-{vt.&vi. （使）扩大； （使）增加； 夸张；|,|\
ɪkˈsi:dɪŋli|ɪkˈsidɪŋli}-{exceedingly}-{exceedingly kind;Thank you. You’ve been exceedingly kind.}-{adv. 非常，极其，特别，十分； 极大地； 过分地； 极度地，极端|,|\
ɪkˈses|ˈɛkˌsɛs}-{excess}-{pay for the excess;Cut any excess fat from the meat.}-{n. 超过； 超额量； 多余量； 放肆|adj. 超重的，过量的，额外的；|,|\
ɪkˈsesɪv|ɪkˈsɛsɪv}-{excessive}-{his excessive drinking}-{adj. 过度的，极度的； 过分的； 过多的； 过逾|,|\
ɪk'sesɪvlɪ|ɪkˈsɛsɪvlɪ}-{excessively}-{excessively high taxes}-{adv. 过度地； 过分地； 极度地；|,|\
ˌeksaɪ'teɪʃən|ˌeksaɪ'teɪʃən}-{excitation}-{inhibit the excitation}-{n. <物>（原子获得高能量的）激发（过程）； 激动； （由刺激引起的器官、组织等的）应激反应； <电>励磁|,|\
ɪkˈskleɪm|ɪkˈsklem}-{exclaim}-{‘No!’ she exclaimed in shock.}-{vt.& vi. 呼喊； 惊叫； 大声说；|,|\
ɪkˈskɜ:ʃn|ɪkˈskɜrʒn}-{excursion}-{We went on an excursion to the Pyramids.}-{n. （尤指集体）远足； 短途旅行，游览； 离题； [机]冲程|,|\
ˈeksɪkju:t|ˈɛksɪˌkjut}-{execute}-{execute a plan ;beautifully/skilfully/poorly etc executed}-{vt. 执行； 处死，处决； 履行； 完成|,|\
ˌeksɪˈkju:ʃn|ˌɛksɪˈkjuʃən}-{execution}-{The two men face execution ;execution of urban policy}-{n. 依法处决； 实行，执行； 演奏；|,|\
ɪgˈzɜ:t|ɪgˈzɜrt}-{exert}-{He has exerted himself tirelessly on behalf of the charity.}-{vt. 发挥； 运用； 使受（影响等）； 用（力）|,|\
ɪgˈzɔ:st|ɪɡˈzɔst}-{exhaust}-{A full day’s teaching exhausts me.}-{vt. 用尽，耗尽； 使精疲力尽； 排出； 彻底探讨|vi. 排气；|n. （排出的）废气； 排出； 排气装置；|,|\
ˌekspəˈdɪʃn|ˌɛkspɪˈdɪʃən}-{expedition}-{an expedition to the North Pole}-{n. 考察，远航； 考察队，远征军； （短途的）旅行； 迅速（办理）|,|\
ɪkˈspend|ɪkˈspɛnd}-{expend}-{expend energy/effort/time/resources etc ;expend something in/on (doing) something}-{vt. 花费； 耗尽； 用光；|,|\
ɪkˈspləʊd|ɪkˈsploʊd}-{explode}-{He exploded into a screaming, kicking rage.}-{vi. 爆[突]发，发怒； 激增，迅速扩大；|vt. （使）爆炸； 突然（发出巨响，活跃起来，迸发感情）； 推翻； 驳倒|,|\
ˌekspləˈreɪʃn|ˌɛkspləˈreʃən}-{exploration}-{the exploration of space}-{n. 探测，勘探，探险； 搜索，研究； [医]探查术；|,|\
ɪkˈsplɔ:rə(r)|ɪkˈsplɔrɚ, -ˈsplor-}-{explorer}-{The great 19th century explorer}-{n. 探险家； 勘探者； 探测器； [医]探针|,|\
ɪkˈspləʊsɪv|ɪkˈsploʊsɪv}-{explosive}-{explosive device}-{adj. 爆炸的； 易爆炸的； 突增的； 暴躁的|n. 爆炸物，炸药； [语言学] 爆破音；|,|\
ɪk'stensɪvlɪ|ɪkˈstɛnsɪvlɪ}-{extensively}-{the extensive use of pesticides}-{adv. 广大地，广泛地；|,|\
ɪkˈstɪəriə(r)|ɪkˈstɪriə(r)}-{exterior}-{the exterior of the factory ;information that is exterior to the text itself}-{n. 外部，外面，表面，外形，外观； 外貌； [影视]外景，[戏，影视]户外布景；|adj. 外面的，外部的，外表上的，表面的；|,|\
ɪk'strɔ:dnrəlɪ|ɪkˈstrɔrdnˌɛrɪlɪ}-{extraordinarily}-{We were extraordinarily lucky.}-{adv. 很，十分，特别，极其； 离奇地； 出奇； 倍加|,|\
ˈaɪsaɪt|ˈaɪˌsaɪt}-{eyesight}-{poor/good/failing etc eyesight}-{n. 视觉，视力； 见解，观察； 眼力；|,|\
ˈfeɪbl|ˈfebəl}-{fable}-{the fable of the fox and the crow}-{n. 寓言，童话； 传说； 无稽之谈； 人人谈论的话题|v. 讲故事，编寓言； 虚构，杜撰； 煞有介事地讲；|,|\
ˈfæbrɪk|ˈfæbrɪk}-{fabric}-{The country’s social fabric is disintegrating.}-{n. 织物； 布； 构造； （建筑物的）结构（如墙、地面、屋顶）：质地|,|\
ˈfæklti|ˈfækəlti}-{faculty}-{the Faculty of Law ;Both faculty and students}-{n. 能力，才能； 全体教职员； <英>（大学的）专科，系； 特权，特许|,|\
feɪd|fed}-{fade}-{Our problems fade into insignificance}-{vi. 褪去，失去光泽； 逐渐消逝； 凋谢，衰老；|vt. 使褪色；|adj. 乏味的，平淡的；|,|\
feɪnt|fent}-{faint}-{a faint hope/possibility/chance}-{adj. 微弱的，模糊的； 软弱的； 无勇气的； 将昏倒似的|vi. 头晕，昏过去； 渐渐不明，消失；|n. 昏厥，昏倒；|,|\
ˈfeəri|ˈferi}-{fairy}-{The child devours fairy tales}-{n. 仙女； 小仙子； 小精灵；|adj. 美丽的，可爱的； 仙女似的；|,|\
ˈfeɪθfl|ˈfeθfəl}-{faithful}-{a faithful friend}-{adj. 忠实的； 忠诚的； 正确的；|n. 信徒；|,|\
feɪk|fek}-{fake}-{I gave a fake name. ;The painting was judged a fake. ;He tried to fake sincerity}-{vt. 伪造； 篡改； 对…做手脚； 仿造|vt.& vi. 假装；|n. 骗子； 冒牌货，赝品； [体]假动作； 冒充，诈骗|adj. 假的，冒充的；|,|\
feɪm|fem}-{fame}-{He claims he is not really interested in fame.}-{n. 名声； 名望； 传闻； 传说|vt. 使闻名； 使出名； 使有名望； <古>盛传|,|\
feə(r)|fer}-{fare}-{bus/train/air/cab fare ;half-fare/full-fare}-{n. 费； 票价； 乘客； 食物|vi. 吃； 进食； 进展； 遭遇|,|\
ˌfeəˈwel|ˌferˈwel}-{farewell}-{bid farewell to ;farewell party/dinner/drink}-{n. 告别，欢送； 欢送会； 告别辞；|int. 再见，再会； 一路平安；|adj. 告别的，送行的；|,|\
ˈfæʃnəbl|ˈfæʃənəbəl}-{fashionable}-{It suddenly became fashionable for politicians to talk about green issues.}-{adj. 流行的； 时髦的，符合时尚的； 时髦人物使用的； （尤指）有钱人常光顾的|n. 时髦的人；|,|\
ˈfɑ:sn|ˈfæsn}-{fasten}-{I was so fat that my skirt wouldn’t fasten. ;Fasten your seat belt.}-{vt. 系牢，钉牢； 使坚固或稳固； 使合在一起：封合； 集中：稳定地集中或指向：|vi. 附着，扣紧； 紧握，紧抱； 集中：显著地注意，集中；|,|\
feɪt|fet}-{fate}-{a fate worse than death}-{n. 命运，宿命； 灾难，死亡； 命中注定的事（尤指坏事）；|v. 注定；|,|\
ˈfɔ:lti|ˈfɔlti}-{faulty}-{the goods are faulty.}-{adj. 错误的； 有错误的，有过失的，有缺点的； 不完美的；|,|\
ˈfeɪvərəbl|ˈfeɪvərəbl}-{favourable}-{favourable film reviews ; favourable for/to}-{adj. 顺利的，良好的； 有利的； 赞许的； 给人好印象的|,|\
ˈfɪəfl|ˈfɪrfl}-{fearful}-{fearful child ; in a fearful mess.}-{adj. 害怕的，担心的； 胆怯的； 吓人的，可怕的； <口>极端的|,|\
ˈfi:zəbl|ˈfizəbəl}-{feasible}-{economically/technically/politically etc feasible}-{adj. 可行的； 可用的； 可实行的； 可能的|,|\
ˈfeðə(r)|ˈfɛðɚ}-{feather}-{an ostrich feather}-{n. 羽毛，翎毛； 状态，心情； 种类； 桨叶的水平运动|v. 给装上羽毛，用羽毛装饰； 使（桨）与水面平行； 长羽毛；|,|\
ˈfɜ:taɪl|ˈfɜrtl}-{fertile}-{fertile cropland}-{adj. 肥沃的； 可繁殖的； 想象力丰富的；|,|\
ˈfɜ:təlaɪzə(r)|ˈfɜrtəlaɪzə(r)}-{fertilizer}-{chemical fertilizer}-{n. 肥料，化肥； 受精媒介物； 促进发展者；|,|\
faɪbə|'faɪbə}-{fiber}-{fibre ;nerve/muscle fibres}-{n. 光纤； （织物的）质地； 纤维，纤维物质；|,|\
ˈfɪkʃn|ˈfɪkʃən}-{fiction}-{romantic fiction}-{n. 小说，虚构的文学作品； 虚构的或想像出的事，并非完全真实的事； 编造，虚构；|,|\
fɪəs|fɪrs}-{fierce}-{fierce dogs}-{adj. 凶猛的，残忍的； 猛烈的； 狂热的；|,|\
ˈfɪltə(r)|ˈfɪltɚ}-{filter}-{water/air/oil etc filter ;The pump filters out mud.}-{n. 滤波器； 滤光器； 滤色镜； [化] 过滤器|vi. 过滤； 透过； 渗透；|vt. 过滤； 滤除；|,|\
ˈfaɪəmən|ˈfaɪərmən}-{fireman}-{firefighter}-{n. 消防队员； [矿]救火员，爆破工； 司炉工；|,|\
ˈfɪʃəmən|ˈfɪʃərmən}-{fisherman}-{a paradise for fishermen}-{n. 渔夫，渔民；|,|\
ˈfɪtɪŋ|ˈfɪtɪŋ}-{fitting}-{new light fittings ;a fitting tribute to the President.}-{n. 试穿，试衣； 设备，器材； 装置； 装修|adj. 适合的，适宜的； 适当的； 相称的；|v. 使适合（fit的现在分词）； 使合身； 与…相符； 安装|,|\
fleɪm|flem}-{flame}-{in flames ;a flame of anger/desire/passion}-{n. 火焰； 热情，激情； 〈俚〉爱人，情人； 激动|vi. 燃烧，发出火焰； 面红； 闪光；|vt. 烧； 激起，激怒；|,|\
flɔ:|flɔ}-{flaw}-{serious/major/basic/minor etc flaw in sth}-{n. 瑕疵，缺点； 一阵狂风； 短暂的风暴； 裂缝，裂纹|v. 使生裂缝，使有裂纹； 使无效； 使有缺陷；|vi. 生裂缝； 变的有缺陷；|,|\
fli:|fli}-{flee}-{His attackers turned and fled.}-{vi. 逃走，逃掉； 消失；|vt. 逃离，逃避；|,|\
fli:t|flit}-{fleet}-{a fleet horse;A fleet sailed for Wales}-{n. 舰队； 船队； 车队； 港湾，小河|adj. 快速的，敏捷的； 转瞬即逝的；|vi. 疾驰； 飞逝；|vt. 使（时间）飞逝； 消磨；|,|\
fləʊt|floʊt}-{float}-{float along/down/past etc}-{vt.& vi. （使）浮动； （使）漂浮； 自由浮动；|vi. 游荡；|vt. 提出，提请考虑； （股票）上市；|n. 彩车； 漂浮物； 浮板； 浮有冰淇淋的饮料|,|\
flɒk|flɑk}-{flock}-{a flock of small birds ;People have been flocking to the exhibition.}-{n. 兽群，鸟群； 群众； 棉束； 大堆，大量|vi. 群集，成群结队而行；|vt. 用棉束填；|,|\
ˈflaʊə(r)|flaʊr}-{flour}-{white/wholemeal/rice/wheat etc flour}-{n. 面粉；|vt. 撒上粉；|,|\
ˈflʌrɪʃ|ˈflɜrɪʃ}-{flourish}-{small businesses are flourishing.}-{vi. 挥舞； 茂盛，繁荣； 活跃，蓬勃；|vt. 挥动，挥舞；|n. 挥舞，挥动； 花样，华丽的辞藻； 夸张的行为或手势； 花式吹奏|,|\
ˈflu:ənt|'fluːənt}-{fluent}-{She was fluent in English ; fluent French/Japanese}-{adj. 流畅的； 流利的； 液态的；|,|\
ˈflu:ɪd|ˈfluɪd}-{fluid}-{fluid ideas;a loose, fluid style of dancing}-{n. 液体，流体；|adj. 流体的，流动的，流体的，液体的； 易变的，不固定的； （动作、设计、音乐等）流畅优美的；|,|\
fɒg|fɔg}-{fog}-{thick/dense/freezing fog ; in a fog}-{n. 雾； 烟雾； 迷惑； 割后再生的草|vt. 以雾包围； 使模糊； 使迷惑；|vi. 为雾笼罩； 朦胧； 照片（模糊）；|,|\
ˈfʊtstep|ˈfʊtˌstɛp}-{footstep}-{He heard someone’s footsteps in the hall.}-{n. 脚步（声）； 足迹；|,|\
fəˈbɪd|fərˈbɪd}-{forbid}-{forbid you to go.}-{vt. 禁止； 阻止； 阻碍； 妨碍|,|\
ˈfɔ:kɑ:st|ˈfɔrkæst}-{forecast}-{profit/sales/growth forecast ;forecast (that)}-{vt. 预报，预测； 预示；|vi. 预报，预测；|n. 预报； 预言；|,|\
ˈfɔ:hed|ˈfɔrhed}-{forehead}-{the lines on her forehead}-{n. 额； 前部；|,|\
fɔ:ˈsi:|fɔrˈsi}-{foresee}-{foresee what/how etc}-{vt. 预知，预见； 有先见之明；|,|\
fɔ:dʒ|fɔrdʒ}-{forge}-{forge ahead with ;forge a relationship/alliance/link etc (with somebody)}-{n. 锻造车间； 熔铁炉，锻铁炉； 铁匠铺，铁匠工场；|vi. 锻制，锻造； 伪造； 犯伪造罪；|vt. 锻造； 伪造； 捏造，编造； 制订|,|\
ˈfɔ:tʃənətli|ˈfɔrtʃənətli}-{fortunately}-{Fortunately, everything worked out all right in the end.}-{adv. 幸运地；|,|\
ˈfaʊntən|ˈfaʊntn}-{fountain}-{A fountain of blood was pouring from his chest.}-{n. 人工喷泉； 喷水池； 喷射； 源泉|,|\
ˈfrækʃn|ˈfrækʃən}-{fraction}-{She paused for a fraction of a second.}-{n. [数]分数； 一小部分，些微； 不相连的一块，片段； [化]分馏|,|\
ˈfrægmənt|ˈfræɡmənt}-{fragment}-{fragments of broken pottery ;the dangers of fragmenting the Health Service}-{n. 碎片； 片段，未完成的部分； （将文件内容）分段；|vt. （使）碎裂，破裂，分裂；|vi. 破碎，碎裂；|,|\
fræŋk|fræŋk}-{frank}-{be frank with somebody ;to be frank}-{adj. 坦白的，直率的； 清楚表明的； 明显的；|n. 弗兰克； 免费邮寄权； 免费邮戳或签名； 免费邮寄的信件|vt. 免费寄（邮件）； 盖免费邮寄公章； 盖邮戳； 便于使（人）自由地来往|,|\
freɪt|fret}-{freight}-{by air freight ;They freighted the boat with bananas}-{n. 货运，货物； 运费； 船运货物； 货运列车|vt. 运输； 装货于；|,|\
ˈfri:kwənsi|ˈfrikwənsi}-{frequency}-{the frequency of serious road accidents ;high/low frequency}-{n. 频繁性； [数][物]频率，次数； 频率分布；|,|\
frɒg|frɔg}-{frog}-{green frog}-{n. 青蛙； 〈侮辱〉青蛙佬，对法国人的蔑称； [交]铁路辙叉； 饰扣，挂环|,|\
ˈfrʌntɪə(r)|frʌnˈtɪr}-{frontier}-{on/at the frontier}-{n. 边疆，边境； 边界，边缘； 尚待开发的领域；|adj. 边疆的，边界的； 新垦地的，边地的； 开拓的；|,|\
frɒst|frɔst}-{frost}-{late/early/first frost ;Overnight all the windowpanes had frosted over.}-{vt.& vi. 使结冰霜； 冻坏； （在蛋糕上）撒糖霜；|vi. 结霜； 受冻；|n. 霜冻，结霜； 严寒，寒冷； 冷淡；|,|\
fraʊn|fraʊn}-{frown}-{Even though divorce is legal, it is still frowned upon.}-{vt.& vi. 皱眉； 不同意； 蹙额；|n. 皱眉，蹙额；|,|\
ˈfru:tfl|ˈfrutfəl}-{fruitful}-{a fruitful source of information}-{adj. 果实累累的； 肥沃的； 效果好的；|,|\
frʌˈstreɪt|ˈfrʌstreɪt}-{frustrate}-{The fact that he’s working with amateurs really frustrates him}-{vt. 挫败； 阻挠； 使受挫折；|adj. 无益的，无效的；|,|\
fʊl'fɪl|fʊlˈfɪl}-{fulfill}-{fulfill duty;We must fulfill the plan}-{vt. 履行（诺言等）； 执行（命令等）； 达到（目的）； 使结束|,|\
fɜ:(r)|fɚ}-{fur}-{imitation/fake/artificial etc fur}-{n. 毛皮； 软毛； 毛皮衣服； 人造毛|adj. 含羊毛的；|vt. 用毛皮覆盖； 除去（锅上的）水垢；|,|\
ˈfɜ:nɪs|ˈfɜrnɪs}-{furnace}-{a melting furnace}-{n. 熔炉，火炉； 极热的地方； 严峻的考验或磨难；|,|\
ˈfɜ:nɪʃ|ˈfɜrnɪʃ}-{furnish}-{furnish sth (with sth)}-{vt. 陈设，布置； 提供，供应； 装修（房屋）；|,|\
ˈgælən|ˈɡælən}-{gallon}-{The car does about 50 miles per gallon .}-{n. 加仑（容量单位）；|,|\
dʒeɪl,dʒel|dʒel}-{gaol}-{in jail ;}-{n. 监狱，拘留所；|vt. 监禁；|,|\
ɡɑ:dnə(r)|ˈɡɑrdnɚ, ˈɡɑrdnɚ}-{gardener}-{She employed a gardener.}-{n. 园丁，园艺家； 花匠； 菜农； 园艺爱好者|,|\
geɪz|ɡez}-{gaze}-{gaze into/at etc}-{vi. 凝视，注视；|n. 凝视，端详；|,|\
ˈdʒenəreɪtə(r)|ˈdʒɛnəˌretɚ}-{generator}-{The company has been a very good cash generator.;turbine generator}-{n. 发电机，发生器； 电力公司； 生产者，创始者； [乐]基础低音|,|\
ˈdʒi:niəs|ˈdʒinjəs}-{genius}-{work/writer/man etc of genius ;musical/comic/mathematical etc genius ;a genius at (doing) something}-{n. 天才； 天赋； 天才人物； （特别的）才能|,|\
dʒiˈɒgrəfi|dʒiˈɑgrəfi}-{geography}-{policemen who knew the local geography}-{n. 地理（学）； 地形，地势； 布局；|,|\
dʒiˈɒmətri|dʒiˈɑmətri}-{geometry}-{mathematics and geometry}-{n. 几何学； 几何形状； 几何图形； 几何学著作|,|\
dʒɜ:m|dʒɜrm}-{germ}-{kill germs}-{n. [生]幼芽，胚芽； 微生物； 起源，萌芽；|,|\
ˈdʒestʃə(r)|ˈdʒɛstʃɚ}-{gesture}-{a gesture of impatience. ;He gestured for her to take a seat}-{n. 手势，姿势； 举止，动作； 〔古语〕仪态； [计算机]光笔指令|vt. 做手势；|vi. 用手势表现，表达或指导；|,|\
gəʊst|goʊst}-{ghost}-{the ghost of anti-Americanism}-{n. 鬼，幽灵； （尤指可怕事物的）记忆； 隐约的一点点； （电视屏幕上的）重影|vt. 悄悄地行进；|vi. 替人代笔；|,|\
ˈgɪvn|ˈɡɪvən}-{given}-{a presentation on a given topic.}-{adj. 指定的，确定的； 假设的，假定的； 有…倾向的； 赠送的|prep. （表示原因）考虑到； （表示假设）倘若，假定；|n. 假设；|v. 给予，赠送( give的过去分词)；|,|\
glɪmps|ɡlɪmps}-{glimpse}-{brief/fleeting/quick glimpse of/into/at ;I glimpsed a figure at the window}-{n. 一瞥，一看； （古语）闪光； 隐约的闪现； 模糊的感觉|vi. 瞥见；|,|\
ˈglɔ:riəs|ˈɡlɔriəs,ˈɡlor-}-{glorious}-{a glorious victory}-{adj. 辉煌的； 荣誉的； 极好的； <口>非常愉快的|,|\
ˈglɔ:ri|ˈɡlɔri, ˈɡlori}-{glory}-{bask/bathe in sb’s/sth’s (reflected) glory}-{n. 光荣，荣誉； 壮观，壮丽； （对上帝的）赞颂； 非常美的事物|vi. 得意，自豪； 骄傲；|,|\
gləʊ|gloʊ}-{glow}-{glow with pride}-{vi. 发光，灼热； 脸红； 洋溢，喜形于色；|n. 白热，炽热； 色彩鲜艳，尤指红光； 激情； 热烈|,|\
glu:|ɡlu}-{glue}-{The sheets are glued together with strong adhesive.}-{vt. 胶合； 紧附于；|n. 胶水； 胶粘物； 粘聚力；|,|\
gaʊn|ɡaʊn}-{gown}-{a white silk wedding gown}-{n. 长袍，长外衣； 女长服； 罩袍； 大学的学生和教师|vt.&vi. 穿长袍；|,|\
greɪs|ɡres}-{grace}-{have the grace to do something ;grace something/somebody with your presence}-{n. 恩泽； 优雅； 慈悲； 魅力|v. 使优美； 惠赐；|,|\
ˈgreɪsfl|ˈɡresfəl}-{graceful}-{graceful and elegant.}-{adj. 优美的，优雅的； 雅致的，美好的； 得体的； 飘逸|,|\
ˈgrædʒuəl|ˈɡrædʒuəl}-{gradual}-{Education is a gradual process.}-{adj. 渐进的，渐（升）降的； 倾斜度小的； 逐次的，逐渐的； 平缓的|n. 弥撒升阶圣歌； 弥撒圣歌集；|,|\
ˈgrædʒuət|ˈɡrædʒuˌet}-{graduate}-{high school graduates ;the boys graduated from high school}-{vi. 渐变； 渐渐变为（与into连用）； 渐渐消逝（与away连用）； 取得资格（与as连用）|vt. 授予学位或毕业证书； 从…接受学位； 分成等级； 标以刻度|n. <美>毕业生； <英>大学毕业生； （已经取得学士学位正在攻读高级学位的）研究生； 量筒|adj. <美>毕业了的，研究生的； 有（学士）学位的；|,|\
greɪn|ɡren}-{grain}-{There is a grain of truth in all folklore and legend.}-{n. 谷物，粮食； （沙，金，盐等的）颗粒； 谷粒，籽粒； （木材，大理石等的）纹理|vt. 把…作成细粒； 把…漆[画]成木纹； 染透； 刮去（皮上的）毛|vi. 成谷粒；|,|\
ɡræm|ɡræm}-{gramme}-{.}-{n. 克；|,|\
greɪp|ɡrep}-{grape}-{a bunch of grapes}-{n. 葡萄； 深紫色，葡萄紫；|,|\
grɑ:sp|græsp}-{grasp}-{grasp any opportunity to}-{vt. 抓住； 了解； 急忙抓住； 急切（或贪婪）地抓住|n. 控制； 控制力； 能力所及；|vi. 攫取（常与 at 连用）； 急于接受； 急切地寻求（常与 for 连用）；|,|\
ˈgrætɪtju:d|ˈgrætɪtud}-{gratitude}-{gratitude to sb;with gratitude}-{n. 感激，感谢； 感激的样子； 谢意； 恩义|,|\
ɡreɪv|greɪv}-{grave}-{grave danger .}-{adj. 重大的，重要的； 严重的； [音乐]沉重的； （颜色等）朴素的|adv. 沉重地，庄重地； 极慢地；|n. 坟墓，墓穴； 埋葬…的地方； 下场； 死亡|vt. 雕刻； 铭记；|,|\
ˈgrævəti|ˈɡrævɪti}-{gravity}-{the force of gravity}-{|,|\
ˈgri:di|ˈɡridi}-{greedy}-{They are greedy for profits.}-{adj. 贪吃的； 贪心的； 贪婪的； 渴望的|,|\
ˈgri:nhaʊs|ˈɡrinˌhaʊs}-{greenhouse}-{greenhouse effect}-{n. 温室，花房； [军]<俚>周围有玻璃的座舱，轰炸员舱；|,|\
gri:t|ɡrit}-{greet}-{greet somebody with cries of welcome.}-{vt. 欢迎，迎接； 致敬，致意； 打招呼； （景象，声音等）映入眼帘|,|\
graɪnd|ɡraɪnd}-{grind}-{grind wheat into flour面粉}-{vt.& vi. 磨碎，嚼碎； 折磨；|vt. 磨快，磨光； 咬牙；|vi. 嘎吱嘎吱地擦；|n. 碾，磨； 苦差事，苦活儿； 〈美〉刻苦用功的学生； 研细的程度|,|\
grɪp|ɡrɪp}-{grip}-{keep an iron grip on ;grip something tightly/firmly}-{n. 紧握，抓牢； 握力； 掌握，理解； 能力，胜任|vt. 握紧，抓牢； 吸引住：吸引…的兴趣或注意力； 引起；|vi. 抓牢，紧握：保持紧握；|,|\
ˈgrəʊsə(r)|ˈgroʊsə(r)}-{grocer}-{I went shopping in his grocer}-{n. 食品商； 杂货商；|,|\
grʌm|grʌm}-{grum}-{.}-{adj. 闷闷不乐的，阴郁的；|,|\
gɪlt|ɡɪlt}-{guilt}-{Don’t you have any feelings of guilt about leaving David?}-{n. 有罪，犯罪行为，罪恶； [法律] 轻罪，过失； 内疚，知罪； 自责|,|\
gʌlf|ɡʌlf}-{gulf}-{a growing gulf between old and young}-{n. 海湾； 分歧； 波斯湾； （地面的）裂口|vt. 吞没； 卷进；|,|\
gʌm|ɡʌm}-{gum}-{chewing gum;resin n. 树脂；松香}-{n. 口香糖； 树胶； 黏胶； 牙龈|vt.& vi. 胶合； 涂以树胶； 使…有粘性；|,|\
dʒɪm|dʒɪm}-{gym}-{I go to the gym as often as I can.}-{n. <非正>健身房； 体育馆； 室内健身操； 体操|,|\
dʒɪmˈneɪziəm|dʒɪmˈneziəm}-{gymnasium}-{gym}-{n. 健身房，体育馆； 大学预科，高级中学；|,|\
hi:ri:z|'hiriz}-{haeres}-{heir;=heres;}-{n. 继承人；|,|\
hɔ:lt|hɔlt}-{halt}-{come/grind/screech etc to a halt ;The government has failed to halt economic decline.}-{n. 停止，中止； 暂停； 小火车站；|vt. 使停止； 使中断； 阻止； 使立定|vi. 停止，立定； 犹豫；|,|\
ˈhæmə(r)|ˈhæmɚ}-{hammer}-{an auctioneer’s hammer ;Hammer the nails into the back of the frame.}-{n. 铁锤，榔头； 链球； （拍卖时用的）木槌； 音槌|vt.& vi. 锤打； 反复敲打，连续击打（尤指发出大声）；|vt. 击败； 猛踢； 猛击； 轻易打败（对方）|,|\
ˈhændbʊk|ˈhændˌbʊk}-{handbook}-{the Fiction Writer’s Handbook}-{n. 手册； 指南；|,|\
ˈhændfʊl|ˈhændˌfʊl}-{handful}-{There were only a handful of people there.}-{n. 少数，少量； 一把（的量）； 难以控制的人（或动物）； 棘手事|,|\
ˈhændraɪtɪŋ|ˈhændˌraɪtɪŋ}-{handwriting}-{My handwriting has never been very neat.}-{n. 书法，手书； 笔迹，字迹；|v. 亲手写(handwrite的ing形式)；|,|\
hæpɪnəs|ˈhæpɪnɪs}-{happiness}-{Juliet’s eyes shone with happiness.}-{n. 幸福； 高兴； 恰当； 合适|,|\
hɑ:bə(r)|ˈhɑrbɚ}-{harbour}-{they sailed into Portsmouth Harbour ;I think he’s harbouring some sort of grudge against me.}-{n. 海港，港口； 港湾； 避难所； 藏身处|vt.&vi. 隐匿； 怀着； 包含，聚藏； 藏有|na. “harbor“的变体；|,|\
ˈhɑ:dn|ˈhɑrdn}-{harden}-{harden your heart}-{vt. 使硬化； 使经得起考验； 使无情； 使轮廓鲜明|vi. 变硬或更硬； 变稳定； 变习惯；|,|\
ˈhɑ:dʃɪp|ˈhɑrdʃɪp}-{hardship}-{Many students are suffering severe financial hardship .}-{n. 艰难； 困苦； 艰难情况； 造成困苦与苦难的原因|,|\
ˈhɑ:dweə(r)|ˈhɑrdwer}-{hardware}-{Hardware Company}-{n. 五金器具； 计算机硬件； 武器装备；|,|\
ˈhɑ:məni|ˈhɑrməni}-{harmony}-{be in harmony with something}-{n. 协调； 融洽，一致； 和谐； [音]和声|,|\
ˈhɑ:nɪs|ˈhɑrnɪs}-{harness}-{a safety harness ;We can harness the power of the wind to generate electricity.}-{n. 马具，挽具； 背带； 系带；|vt. 利用； 给（马等）套轭具； 控制；|,|\
hɑ:ʃ|hɑrʃ}-{harsh}-{be harsh to sb/sth}-{adj. 粗糙的； 刺耳的； 严厉的，严格的； 残酷的|,|\
heɪst|heɪst}-{haste}-{In his haste to leave, he forgot his briefcase.}-{n. 匆忙，急忙； 急速，紧迫； 轻率；|v. 赶紧，匆忙； <古>使快，催促；|,|\
ˈheɪtrɪd|ˈhetrɪd}-{hatred}-{hatred of/for/towards}-{n. 仇恨，憎恶； 敌意；|,|\
heɪ|he}-{hay}-{make hay (while the sun shines)}-{n. 干草； 少量的钱； 一种乡村舞蹈； 成果，酬报|vt. 把（草）制成干草； 用干草喂；|vi. 割草晒干；|,|\
ˈhæzəd|ˈhæzərd}-{hazard}-{full of hazards; I’m only hazarding a guess .}-{vt. 冒险； 使遭受危险；|n. 危险； 冒险的事； 机会； 双骰子游戏|,|\
ˈhedɪŋ|ˈhɛdɪŋ}-{heading}-{come under the heading of}-{n. 标题，题名； 信头； [航]航向； 斩首|v. 用头顶(head的现在分词)；|,|\
ˈhedlaɪn|ˈhedlaɪn}-{headline}-{make/grab (the) headlines}-{n. 大字标题； 新闻提要； 头条新闻；|vt. 给…加标题； 担任主角；|,|\
hi:l|hil}-{heal}-{heal the sick}-{vt. 恢复健康的状态； 使恢复正常； 使（某人）精神恢复健康；|vi. 变得完整和健全；|,|\
hi:p|hip}-{heap}-{heaps of ;Jean heaped logs on the fire. ;He heaped all the blame on his secretary.}-{n. 堆，堆积； <口>许多，大量； <俚>破车；|vt. 扔成一堆； 完全填满，灌满； 大量或奢侈的赠予；|,|\
hi:v|hiv}-{heave}-{Alan heaved his suitcase onto his bed. ;heave a sigh}-{vt. 举起； 投掷； 使起伏； 呕吐|vt.& vi. 喘息； 呕吐；|vi. 起伏； （山丘等）隆起； 拖； 气喘|n. 举起； 波动； 隆起； 呕吐|,|\
hedʒ|hɛdʒ}-{hedge}-{a hedge against sth;Smart managers will hedge against price increases.}-{n. 树篱； 保护手段； 防止损失（尤指金钱）的手段；|vt. 用树篱围起； 受…的束缚；|vt.& vi. 回避，避免；|adj. 树篱下的，树篱旁的； 偷偷摸摸的，名声不好的，低劣的；|,|\
hi:l|hil}-{heel}-{As soon as he saw me he took to his heels.}-{n. 脚后跟，踵； （鞋、袜等的后跟）； （四足动物的）后脚； 踵状物|vt.& vi. （使）倾斜；|vt. 给（鞋等）修理后跟；|,|\
ˈhaɪtn|ˈhaɪtn}-{heighten}-{The case has heightened public awareness of the problem of sexual harassment.}-{vt.& vi. （使）变高； （使）加强；|,|\
ˈhelɪkɒptə(r)|ˈhelɪkɑptə(r)}-{helicopter}-{You can helicopter to the island; the rescue helicopter}-{n. 直升机，直升飞机；|vt. 用直升飞机载送；|vi. 乘直升飞机；|,|\
ˈhelpləs|ˈhɛlplɪs}-{helpless}-{helpless laughter/rage/tears ;I was helpless with fear.}-{adj. 无助的； 无能的； 无用的； 六亲无靠|,|\
ˈhemɪsfɪə(r)|ˈhemɪsfɪr}-{hemisphere}-{south hemisphere}-{n. 半球； 地球的半球； [解]大脑半球；|,|\
hen|hɛn}-{hen}-{The chickens gathered under the hen}-{n. 母鸡； 雌禽； 女人；|,|\
hɜ:d|hɜrd}-{herd}-{a herd of cows}-{n. 兽群； 牧群； 放牧人； <蔑>群众，民众|vt.& vi. 群集，纠结；|vt. 放牧； （使）向…移动； 使成群；|,|\
ˈherɪtɪdʒ|ˈhɛrɪtɪdʒ}-{heritage}-{cultural/architectural/literary etc heritage}-{n. 遗产； 继承物； 传统； 文化遗产|,|\
həˈrəʊɪk|həˈroʊɪk}-{heroic}-{heroic efforts}-{adj. 有英雄气概的，英雄的，英勇的； 记叙英雄及其事迹的； 夸张的；|n. 英雄诗，史诗； 英勇行为； 夸张的言行； 咬文嚼字，文诌诌|,|\
ˈherəʊɪn|ˈheroʊɪn}-{heroine}-{My heroine was Elizabeth Taylor}-{n. 女主角； 女英雄； 女杰出人物；|,|\
hɪnt|hɪnt}-{hint}-{helpful hints}-{n. 线索，迹象； 提示，注意事项； 暗示； 微量|vt. 暗示；|vi. 暗示，提示；|,|\
hɪp|hɪp}-{hip}-{with her hands on her hips}-{n. 臀部； [建筑学]屋脊； 臀围（尺寸）； 臀部…的|adj. （衣服、音乐等方面）时髦的，赶时髦的；|vt. 使…的髋关节脱臼，损伤…的髋部； [建筑学]给（房屋）建屋脊； 使知晓，使了解，告诉； 使消息灵通|,|\
hɪˈstɒrɪk|hɪˈstɔrɪk}-{historic}-{the restoration of historic buildings}-{adj. 在历史上重要的，有历史影响的； 历史的，历史上的；|,|\
ˈhɒbi|ˈhɑbi}-{hobby}-{What are your hobbies?}-{n. 业余爱好； 嗜好，兴趣； 小马；|,|\
ˈhɒləʊ|ˈhɑloʊ}-{hollow}-{hollow eyes/cheeks ;hollow laugh/voice}-{adj. 空的； 空洞的； 虚伪的； 空腹的|n. 洞，坑； 山谷；|vt.& vi. 挖空（某物），变空； 挖出（孔、洞）；|adv. 完全，彻底；|,|\
ˈhʌnimu:n|ˈhʌniˌmun}-{honeymoon}-{honeymoon period; I was on my honeymoon}-{n. 蜜月； 蜜月期； 蜜月旅行； 短暂的和谐时期|vi. 度蜜月；|,|\
ˈɒnərəbl|ˈɑːnərəbl}-{honourable}-{a principled and honourable man}-{adj. 诚实的，正直的； 光荣的，荣耀的； 尊敬的； 高尚的|,|\
ˈhəʊpfl|ˈhoʊpfl}-{hopeful}-{Everyone’s feeling pretty hopeful about the future.}-{adj. 抱有希望的； 给人以希望的；|n. 有成功希望的人；|,|\
həˈraɪzn|həˈraɪzn}-{horizon}-{broaden/expand sb’s horizons}-{n. 地平线； 范围； 界限； 眼界|,|\
ˌhɒrɪˈzɒntl|ˌhɔrəˈzɑntl}-{horizontal}-{a horizontal surface}-{adj. 水平的，卧式的； 地平线的； [植]（枝条）平层的； 同一行业的，同阶层的|n. 水平线； 水平面； 水平位置； 水平的物体|,|\
hɔ:n|hɔrn}-{horn}-{He sounded the car horn;A mature cow has horns.}-{n. 角，触角； 号角，喇叭； 角质； 角状物|vi. 不请自来； 闯入；|,|\
ˈhɔ:spaʊə(r)|ˈhɔrspaʊə(r)}-{horsepower}-{a 300-horsepower engine.}-{n. <物>马力；|,|\
ˌhɒspɪˈtæləti|ˌhɑspɪˈtæləti}-{hospitality}-{Thanks for your hospitality over the past few weeks.}-{n. 殷勤好客； 招待，款待； （气候，环境等的）宜人，适宜；|,|\
ˈhəʊstəs|ˈhoʊstəs}-{hostess}-{The hostess introduced them.}-{n. 女主人； （夜总会的）女招待； （电视或广播节目的）女主持人； （餐馆的）迎宾女招待|vt. 作东，请客；|,|\
ˈhɒstaɪl|ˈhɑstl}-{hostile}-{hostile attitude ;hostile to/towards}-{adj. 敌人的，敌对的； 怀有敌意的； 不利的；|n. 敌对者，敌对物； 敌方；|,|\
hʌm|hʌm}-{hum}-{hum a song}-{vt. 哼唱；|vi. 忙碌，活跃； 发嗡嗡声； 发出嘈杂声；|n. 嗡嗡声； 杂音； 哼唱的动作；|int. 哼； 嗯；|,|\
hju:ˈmænəti|hjuˈmænɪti}-{humanity}-{crimes against humanity}-{n. 人类； 人性； 人道； 人文学科|,|\
ˈhʌmbl|ˈhʌmbəl}-{humble}-{humble background/origins ;a modest and humble man}-{adj. 谦逊的； 简陋的； （级别或地位）低下的； 不大的|vt. 使谦恭； 轻松打败（尤指强大的对手）； 低声下气；|,|\
ˈhju:mərəs|ˈhjumərəs}-{humorous}-{humorous stories}-{adj. 幽默的； 滑稽的； 风趣的； 谐|,|\
ˈhju:mə(r)|ˈhjumɚ}-{humour}-{his humour and charm ;in a good/an ill/a bad humour}-{n. 幽默； 幽默感 ； 感觉； 体液|v. 迁就； 顺应；|,|\
ˈhʌŋgə(r)|ˈhʌŋɡɚ}-{hunger}-{die of/from hunger}-{n. 饿，饥饿； 欲望；|vt.& vi. （使）饥饿；|vi. 渴望；|,|\
ˈhʌrɪkən|ˈhɜrəkən}-{hurricane}-{tonado 龙卷风;protect them from hurricane damage}-{n. 飓风，十二级风； 飓风般猛烈的东西； （感情等的）爆发； <英>飓风式战斗驱逐机|,|\
hʌt|hʌt}-{hut}-{a wooden hut}-{n. 小屋； 棚屋； 临时营房； 牢房|v. 使住临时营房； 驻扎；|,|\
ˈhaɪdrədʒən|ˈhaɪdrədʒən}-{hydrogen}-{Water contains hydrogen and oxygen}-{n. <化>氢；|,|\
ˈɪdiəm|ˈɪdiəm}-{idiom}-{the new musical idiom}-{n. 习语，成语； 方言，土语； （语言）风格； 惯用语法|,|\
ˈaɪdl|ˈaɪdl}-{idle}-{The whole team stood idle ;idle chatter/talk/gossip ;let the boat idle.}-{adj. 无意义的； 空闲的； 懒惰的； 无根据的|vi. 虚度； 空转； 挂空挡； 未熄火|vt. 虚度； 使空转；|n. （尤指暂时地）关闭工厂，使（工人）闲着；|,|\
ɪˈlu:ʒn|ɪˈluʒən}-{illusion}-{She had no illusions about}-{n. 错觉； 幻想； 错误观念； 假象|,|\
ɪˈmædʒɪnəri|ɪˈmædʒɪneri}-{imaginary}-{she played an imaginary piano on her knees.}-{adj. 想像中的，假想的，虚构的； [数]虚数的； 幻； 虚幻|,|\
ɪˈmædʒɪnətɪv|ɪˈmædʒənətɪv, -ˌnetɪv}-{imaginative}-{imaginative writers;an imaginative solution to the litter problem}-{adj. 富于想像力的，运用想像力的； 想象或创造出来的； 沉溺于想象的； 虚假的|,|\
ˈɪmɪteɪt|ˈɪmɪˌtet}-{imitate}-{to imitate Winston Churchill.}-{vt. 模仿，效仿； 仿造，伪造；|,|\
ˌɪmɪˈteɪʃn|ˌɪmɪˈteʃən}-{imitation}-{by imitation;his imitation of an American accent}-{n. 模仿，仿效； 仿制品； 赝品； [生]拟态|adj. 人造的； 仿制的；|,|\
ɪˈmens|ɪˈmɛns}-{immense}-{an immense amount}-{adj. 极大的，巨大的； 浩瀚的，无边际的； 〈口〉非常好的； 弘道|,|\
ɪmˈpeɪʃnt|ɪmˈpeʃənt}-{impatient}-{become/grow impatient (with somebody/something)}-{adj. 不耐烦的； 热切的，渴望的； 不能容忍的，恼火的；|,|\
ɪmˈperətɪv|ɪmˈpɛrətɪv}-{imperative}-{imperative needs;it is imperative (for somebody) to do something}-{adj. 必要的，不可避免的； 命令的，专横的； 势在必行的； [语]祈使的|n. 必要的事； 命令； 规则； [语]祈使语气|,|\
ɪnˈdɪfrənt|ɪnˈdɪfərənt, -ˈdɪfrənt}-{indifferent}-{an indifferent book}-{adj. 漠不关心的； 无关紧要的； 中立的； 中等的|,|\
ˌɪndəˈrekt|ˌɪndɪˈrɛkt, -daɪ-}-{indirect}-{The indirect effects}-{adj. 间接的； 不直截了当的； 闪烁其词的； 不坦率的|,|\
ˌɪndɪˈspensəbl|ˌɪndɪˈspɛnsəbəl}-{indispensable}-{Meat is not indispensable for maintaining a healthy diet.}-{adj. 不可缺少的； 绝对必要的； 责无旁贷的； 不可避开的|n. 不可缺少的人或物；|,|\
ˈɪndɔ:(r)|ˈɪnˌdɔr, -ˌdor}-{indoor}-{an indoor swimming pool}-{adj. 室内的，户内的； 在室内使用的； 待在家里的； 救济院内的|,|\
ɪnˈdʌstriəlaɪz|ɪnˈdʌstriəˌlaɪz}-{industrialize}-{the factories will industrialize the countryside ;easy to industrialize}-{vt.& vi. （使）工业化；|,|\
ɪnˈfekt|ɪnˈfɛkt}-{infect}-{infected with cholera 被传染上霍乱;Lucy’s enthusiasm soon infected the rest of the class.}-{vt. 使受影响，感染； 传染，散布病毒，侵染； （电脑病毒）使（电脑的）存储器[数据]受到感染；|,|\
ɪnˈfɪəriə(r)|ɪnˈfɪriə(r)}-{inferior}-{be inferior to sb}-{adj. （质量等）低劣的； 下级的，下等的； （位置在）下面的； [植]下位的|n. 部下，下属； 次品； 晚辈； [印]下角码|,|\
ˌɪnfluˈenʃl|ˌɪnfluˈɛnʃəl}-{influential}-{Dewey was influential in shaping economic policy.}-{adj. 有影响的； 有权势的；|n. 有影响力的人物；|,|\
ɪnˈgri:diənt|ɪnˈgridiənt}-{ingredient}-{John has all the ingredients of a great player.}-{n. （混合物的）组成部分； （烹调的）原料； （构成）要素； 因素|,|\
ɪnˈhæbɪt|ɪnˈhæbɪt}-{inhabit}-{The woods are inhabited by many wild animals.}-{vt. 居住； 在…出现； 填满；|vi. 居住；|,|\
ɪnˈhæbɪtənt|ɪnˈhæbɪtənt}-{inhabitant}-{a city of six million inhabitants}-{n. 居民，住户； （栖息在某地区的）动物；|,|\
ɪnˈherɪt|ɪnˈhɛrɪt}-{inherit}-{inherit something from somebody}-{vt.& vi. 继承；|vt. 经遗传获得（品质、身体特征等），继任；|,|\
ɪnˈdʒekt|ɪnˈdʒɛkt}-{inject}-{I have to inject myself with insulin.}-{vt. （给…）注射（药物等）； （给…）注射（液体）； （给…）添加； （给…）投入（资金）|,|\
ɪnˈdʒekʃn|ɪnˈdʒɛkʃən}-{injection}-{The children hate having injections.}-{n. 注射； 注射剂； [医]充血； （卫星等的）入轨|,|\
ˌɪnˈlænd|ˈɪnlənd}-{inland}-{the largest area of inland water in the southeast}-{adj. 内地的，内陆的； 国内的；|adv. 向内地，在内地； 向内陆，在内陆；|n. 内地，内陆； 国内；|,|\
ɪn|ɪn}-{inn}-{We’re staying at the Holiday Inn.}-{n. 小旅馆，客栈； 小饭店，小酒馆；|vi. 住旅馆；|,|\
ɪn'kwaɪə(r)|ɪnˈkwaɪr}-{inquire}-{inquire whether/why/how etc}-{vt.& vi. 打听，询问； 查究；|,|\
ɪnˈspaɪə(r)|ɪnˈspaɪr}-{inspire}-{He inspired many young people to take up the sport.}-{vt. 鼓舞； 激励； 赋予灵感； 启迪|vi. 吸，吸入；|,|\
ˌɪnstəˈleɪʃn|ˌɪnstəˈleʃən}-{installation}-{a secret military installation}-{n. 安装； 装置； 永久性军事基地； 就职|,|\
ˈɪnstəntli|ˈɪnstəntli}-{instantly}-{All four victims died instantly.}-{adv. 立即，马上，立刻； 马上地； 即刻地； 立即地|conj. 一…就；|,|\
ˈɪnstɪŋkt|ˈɪnˌstɪŋkt}-{instinct}-{sexual/maternal/survival instinct}-{n. 本能，天性； 冲动； 天资，天才；|adj. 深深地充满着；|,|\
ˌɪnstrəˈmentl|ˌɪnstrəˈmɛntl}-{instrumental}-{instrumental music 器乐曲.;instrument n.}-{adj. 乐器的； 仪器的； 有帮助的； 起作用的|,|\
ɪnˈsʌlt|ɪnˈsʌlt}-{insult}-{They insult us by ignoring our complaints. ;Some advertising is an insult to our intelligence.}-{vt. 侮辱，凌辱； 辱骂； 损害；|,|\
ɪnˈʃʊə(r)|ɪnˈʃʊr}-{insure}-{Take advice to insure yourself against being misled}-{vt. 保证； 确保； 为…保险； 投保|vi. 买卖或卖保险；|,|\
ɪnˈtenʃənl|ɪnˈtɛnʃənəl}-{intentional}-{I did trip him, but it wasn’t intentional.;intention n.}-{adj. 有意的，故意的； 策划的；|,|\
ˌɪntəˈfɪə(r)|ˌɪntərˈfɪr}-{interfere}-{I don't want to interfere with you; proceed with your work}-{vi. 干预，干涉； 调停，排解； 妨碍，打扰；|,|\
ˌɪntəˈfɪərəns|ˌɪntərˈfɪrəns}-{interference}-{I resent his interference in my work.;interfere}-{n. 干涉，干扰，冲突； 介入； 妨碍，打扰，阻碍物； 冲突，抵触|,|\
ɪnˈtɪəriə(r)|ɪnˈtɪriə(r)}-{interior}-{an interior room}-{n. 内部； 内地； 内政； 内心|adj. 内部的； 内地的，国内的； 内面的；|,|\
ɪnˈtɜ:prɪtə(r)|ɪnˈtɜrprɪtə(r)}-{interpreter}-{Speaking through an interpreter}-{n. 解释者； 口译译员； [军事]判读员； [自]翻译器|,|\
ˌɪntəˈrʌpt|ˌɪntəˈrʌpt}-{interrupt}-{Will you stop interrupting me!}-{vt.& vi. 打断（别人的话等）； 阻止； 截断；|vt. 暂停； 中断； 打扰； 妨碍|vi. 打断；|n. 中断； 暂停；|,|\
ˌɪntəˈrʌpʃn|ˌɪntəˈrʌpʃən}-{interruption}-{We can talk here without interruption.}-{n. 中断； 打断； 障碍物； 打岔的事|,|\
ˈɪntɪmət|ˈɪntəmɪt}-{intimate}-{an intimate meal for two ;She had already intimated to me her wish to leave.}-{adj. 亲密的，亲近的； 私人的，个人的； 内部的； 直接的|n. 至交； 密友；|v. 暗示，提示； 宣布，通知；|,|\
ɪnˈveɪd|ɪnˈved}-{invade}-{The Romans invaded Britain 2000 years ago.}-{vt.& vi. 侵入，侵略； 进行侵略； 蜂拥而入，挤满； （疾病，声音等）袭来，侵袭|vt. 涌入； 侵袭； 侵犯； 干扰|,|\
ɪnˈveɪʒn|ɪnˈveʒən}-{invasion}-{invasion of privacy}-{n. 入侵，侵略； 侵害，侵犯； 侵袭； [医]发病|,|\
ɪnˈvent|ɪnˈvɛnt}-{invent}-{They invented a very convincing alibi.}-{vt. 发明，创造； 虚构；|,|\
ɪnˈvenʃn|ɪnˈvɛnʃən}-{invention}-{The dishwasher is a wonderful invention.}-{n. 发明； 发明物； 捏造：内心捏造的东西，特指谎言； 发明才能|,|\
ɪnˈvɜ:t|ɪnˈvɜrt}-{invert}-{invert a glass}-{vt. 使…前后倒置； 使反转；|n. 颠倒的事物； 变性者；|adj. 转化的；|,|\
ˌɪnvɪˈteɪʃn|ˌɪnvɪˈteʃən}-{invitation}-{an invitation to do something ;be an open invitation for/to somebody}-{n. 招待，邀请； 请柬，请帖； 引诱，吸引，诱惑；|,|\
ˈɪnwəd|ˈɪnwərd}-{inward}-{inward panic ;I managed to smile, but inwardly I was furious.}-{adj. 向内的； 内部的； 本质上的； 亲密的|adv. 向内； 内心里；|n. 内部； 内脏；|,|\
ˌɪrɪ'ɡeɪʃn|ˌɪrɪ'ɡeɪʃn}-{irrigation}-{major irrigation projects}-{n. 灌溉； 水利； [医]冲洗； 冲注洗剂|,|\
dʒeɪl|dʒel}-{jail}-{in jail ;They ought to jail her killer for life.}-{n. 监狱； 拘留所；|vt. 监禁； 拘留；|,|\
dʒɑ:(r)|dʒɑr}-{jar}-{a jam jar ;The screaming was starting to jar on my nerves .}-{n. 罐子； （啤酒）杯； 缸； 猛然震动|vi. 发出刺耳的声音； 不和谐； 不一致； （对…）产生不快的影响|vt. 使震动；|,|\
dʒɔ:|dʒɔ}-{jaw}-{lower/upper jaw}-{n. 下巴； 颌； 唠叨； 狭窄入口|vi. 闲谈； 唠唠叨叨，喋喋不休； 教训；|,|\
dʒæz|dʒæz}-{jazz}-{a jazz band}-{n. 爵士乐，爵士舞（曲）；|,|\
ˈdʒeləs|ˈdʒɛləs}-{jealous}-{Why are you so jealous of his success?}-{adj. 妒忌的； 羡慕的； 精心守护的； 吃醋的|,|\
dʒi:nz|dʒinz}-{jeans}-{in jeans}-{n. 牛仔裤； 瘦腿紧身裤；|,|\
dʒet|dʒɛt}-{jet}-{He owns a private jet . ;business executives jetting around the world}-{n. 喷嘴，喷雾； 喷气式飞机； 喷射流； 煤玉|vi. 乘喷气式飞机； 射出；|adj. 黑玉制的或黑玉似的； 象炭一般黑的；|vt. 喷射，喷出；|,|\
ˈdʒu:əl|ˈdʒuəl}-{jewel}-{the jewel in the crown}-{n. 宝石，宝石饰物； 受珍视的人[物]； 宝贝，手表的宝石轴承；|,|\
ˈdʒʌdʒmənt|ˈdʒʌdʒmənt}-{judgement}-{professional/personal etc judgment}-{n. 判断，鉴定，评价，判断； 审判，裁判，判决； 看法，意见； 判断力，见识|,|\
ˈdʒʌŋgl|ˈdʒʌŋɡəl}-{jungle}-{a jungle of the dense jungles}-{n. （热带）丛林； 丛林音乐； 乱七八糟的一堆事物； 尔虞我诈的环境|,|\
ˈkɪndəgɑ:tn|ˈkɪndərgɑrtn}-{kindergarten}-{She's in kindergarten now.}-{n. 幼儿园，学前班；|,|\
 'kaɪn(d)nəs| 'kaɪndnəs}-{kindness}-{I can’t thank you enough for your kindness.}-{释义 [人名] 坎德尼斯；|,|\
ˈkɪŋdəm|ˈkɪŋdəm}-{kingdom}-{The kingdom's power declined}-{n. 王国； 界； 领域；|,|\
ni:l|nil}-{kneel}-{Tom knelt down and patted the dog.}-{vi. 跪，下跪；|,|\
nɒt|nɑt}-{knot}-{tie a knot}-{n. 结，绳结，结节，（装饰用的）花结，蝴蝶结； [航]节(=浬/小时)，浬，海里； （树木或木材上的）节疤，（人或动物身上的）硬块，节，瘤； 难事，难题，麻烦事，（问题的）要点，（戏剧，小说的）情节的征结|vt.& vi. 把…打结，把…连结，捆扎，包扎； 使密切结合； 使纠结； 皱（眉）|,|\
læg|læɡ}-{lag}-{Britain is lagging behind the rest of Europe.}-{vi. 走得极慢，落后；|vt. 落后于； 给…加上外套； 把…关进牢里； 逮捕|n. 滞后，（两事件之间的）时间间隔； 囚犯； 防护套； 桶板|,|\
leɪm|leɪm}-{lame}-{a lame excuse}-{adj. 跛的，瘸的； 僵痛的； 差劲的，无说服力的； 蹩脚的|vi. 变跛；|vt. 使跛，使残废； 把…弄残废；|n. （金属）薄板，薄片； （古代护身甲上的）重叠金属片；|,|\
ˈlæntən|ˈlæntərn}-{lantern}-{a lantern hanging over the door}-{n. 灯笼； 灯塔； 灯罩； 灯饰|,|\
læp|læp}-{lap}-{on sb’s lap ;The waves lapped gently against the rocks.}-{vt. 折叠； 包裹，缠绕； 使搭接； 磨亮，磨平|vi. 折叠； 部分重叠； 舔； 包围|n. 膝； 下摆； 一圈跑道； 范围|,|\
ˈleɪzə(r)|ˈlezɚ}-{laser}-{new laser technology.}-{n. 激光； 激光器，镭射器；|,|\
ˈlætərəl|ˈlætərəl}-{lateral}-{lateral support. ;}-{adj. 侧面的； 横向的； [语]边音的；|n. 侧部的东西； 边音；|,|\
ˈlɑ:ftə(r)|ˈlæftə(r)}-{laughter}-{Audiences roared with laughter.}-{n. 笑，笑声； 〈古〉好笑的事； 〈美俚〉力量悬殊得可笑的体育比赛； 大笑|,|\
ˈlɔ:ndri|ˈlɔndri, ˈlɑn-}-{laundry}-{a pile of dirty laundry ;She did the laundry}-{n. 洗衣店，洗衣房； 洗好的衣服； 待洗的衣服； 洗熨|,|\
ˈlævətri|ˈlævətɔri}-{lavatory}-{lavatory cover;the ladies' lavatory.}-{n. 厕所； 盥洗室； <宗>洗礼盆；|,|\
lɔ:n|lɔn}-{lawn}-{I spent all morning mowing the lawn}-{n. 草地，草坪； 上等细麻布；|,|\
ˈleɪaʊt|ˈleˌaʊt}-{layout}-{the layout of the park}-{n. 布局，安排，设计； 布置图，规划图；|,|\
li:k|lik}-{leak}-{leak into/from/out ;a gas leak}-{vi. 漏出； 透露； （指消息，秘密等）泄密； 漏电，漏水|vt. 使泄露； <非正式> 擅自公开；|n. 泄漏，漏洞； 裂缝； 漏出物； （俚语）撒尿|,|\
li:p|lip}-{leap}-{leaped over the wall}-{vi. 跳； 冲动的行动；|vt. 跳过，跃过； 使跳跃；|n. 跳跃，飞跃； 跳跃的距离；|,|\
ˈlɜ:nɪd|ˈlɜrnɪd}-{learned}-{a learned professor}-{adj. 有学问的； 博学的； 学术上的； 精通某门学问的|v. 学习(learn的过去式和过去分词)； 得知；|,|\
ˈlɜ:nɪŋ|ˈlɜrnɪŋ}-{learning}-{a man of great learning}-{n. 学问，学术，知识；|v. 学习(learn的现在分词)；|,|\
li:s|lis}-{lease}-{The lease has four years left to run}-{n. 租约； 租契； 租赁物； 租赁权|vt. 出租； 租借；|,|\
ˈlemən|ˈlɛmən}-{lemon}-{a slice of lemon.}-{n. 柠檬； 柠檬树； 柠檬黄；|adj. 柠檬色的；|,|\
lenz|lɛnz}-{lens}-{a standard 50 mm lens}-{n. 透镜，镜头； 眼睛中的水晶体； 隐形眼镜； 汽车的灯玻璃|,|\
lest|lɛst}-{lest}-{He paused, afraid lest he say too much.}-{conj. 唯恐； 以免； 惟恐； 生怕|,|\
ˈlaɪəbl|ˈlaɪəbəl}-{liable}-{be liable for military service.}-{adj. 有责任的； 有义务的； 有…倾向的； 易…的|,|\
ˈlɪbəti|ˈlɪbərti}-{liberty}-{liberty and equality ;take liberties with somebody/something}-{n. 自由； 许可权； 放肆，无礼； 解放，释放|,|\
laɪˈbreəriən|laɪ'brerɪrn}-{librarian}-{The new librarian is a friend of mine}-{n. 图书管理员； [计算机]库管理程序；|,|\
ˈlaɪtnɪŋ|ˈlaɪtnɪŋ}-{lightning}-{he was struck by lightning}-{adj. 闪电般的，快速的；|n. 闪电，雷电；|vi. 打闪；|,|\
ˈlaɪklihʊd|ˈlaɪkliˌhʊd}-{likelihood}-{There was very little likelihood of her getting the job.}-{n. 可能，可能性； [数]似然，似真；|,|\
lɪm|lɪm}-{limb}-{He’d gone out on a limb (= taken a risk ) to help us. ;a lost limb}-{n. 肢，翼； 大树枝； 分支； 枝干|vt. 割断…的四肢，肢解； 砍树枝；|,|\
ˈlɪkə(r)|ˈlɪkɚ}-{liquor}-{hard liquor; liquor up醉倒; liqueur}-{n. 酒，烈性酒； 含酒精饮料；|vt. 浸泡； 喝酒；|,|\
li:tə(r)|ˈlitɚ}-{liter}-{drink more than a liter}-{n. [计量] 公升（容量单位）；|,|\
ˈlɪtərəsi|ˈlɪtərəsi}-{literacy}-{a new adult literacy campaign}-{n. 识字； 有文化； 能读能写； 精通文学|,|\
ˈlɪvə(r)|ˈlɪvɚ}-{liver}-{bile}-{n. 肝脏； （食用）肝； 深赤褐色； 生活者|adj. 肝味的； 深赤褐色的；|,|\
ləʊf|loʊf}-{loaf}-{a loaf of bread}-{n. 一条（块）面包；|v. 游荡； 游手好闲；|,|\
ˈlɒbi|ˈlɑbi}-{lobby}-{a hotel lobby ;his group is lobbying for a reduction in defence spending.}-{n. 门厅，大厅； 休息室； 游说团； 投票厅|vi. 为了支持或抵制某项特定目标游说；|vt. 对…进行游说； 陈情（试图努力影响某人采取有利行动）；|,|\
ləʊˈkæləti|loʊˈkæləti}-{locality}-{in the locality}-{n. 位置； 地区； 产地；|,|\
lɒdʒ|lɑdʒ}-{lodge}-{lodge a complaint/protest/appeal ;the porter’s lodge ;The fishbone lodged in her throat.}-{vi. 存放； 暂住； 埋入； （权利、权威等）归属|vt. 提出（报告、要求、申诉等）； 容纳； 寄存； 把（权利、权威等）授予|n. <古>小屋，草屋； （北美印第安人的）帐篷； （森林、猎场等的）看守小屋； （学校、工厂等的）传达室|,|\
lu:p|lup}-{loop}-{A loop of wire ;He looped the rope over the post.}-{n. 圈，环； [医]宫内避孕环； 回路； 弯曲部分|vt.& vi. （使）成环，（使）成圈； 以环连结； 使翻筋斗；|,|\
ˈlu:sn|ˈlusən}-{loosen}-{loosen your grip/hold}-{vt. 解开或使松； 放宽，放松； 使（肠）通畅；|vi. 变松或变得更松；|,|\
ˈlɔɪəl|ˈlɔɪəl}-{loyal}-{a loyal supporter}-{adj. 忠诚的，忠心的； 忠贞的；|n. 效忠的臣民； 忠实信徒；|,|\
ˈlɔɪəlti|ˈlɔɪəlti}-{loyalty}-{loyalty to/towards}-{n. 忠诚，忠实； 忠心； 忠于…感情；|,|\
ˈlʌgɪdʒ|ˈlʌɡɪdʒ}-{luggage}-{Leave your luggage in the hotel.}-{n. <英>行李； <美>皮箱；|,|\
lʌŋ|lʌŋ}-{lung}-{The broken ribs perforated into his lung}-{n. 肺； 呼吸器官； [医]辅助呼吸的装置； 〈英〉可供呼吸新鲜空气的地方|,|\
ˈlʌkʃəri|ˈlʌɡʒəri, ˈlʌkʃə-}-{luxury}-{in luxury ;luxury hotel}-{n. 奢侈，豪华； 奢侈品，美食，美衣； 乐趣，享受； 不常有的乐趣（或享受、优势）|adj. 奢华的，豪华的；|,|\
ˈmægnət|'mæɡnət}-{magnet}-{a gigantic magnet}-{n. 磁铁，磁石； 有吸引力的人或物； [物]磁体；|,|\
mægˈnetɪk|mæɡˈnɛtɪk}-{magnetic}-{magnetic forces}-{adj. 有磁性的，有吸引力的； 磁性的； 有吸引力的； 有魅力的|,|\
mægˈnɪfɪsnt|mæɡˈnɪfɪsənt}-{magnificent}-{a magnificent performance;magni-,巨大的}-{adj. 壮丽的； 伟大的，高尚的； 华丽的，高贵的； 瑰丽的|,|\
meɪd|med}-{maid}-{a kitchen maid}-{n. 女仆，侍女； 少女； 处女，未婚女子；|,|\
ˈmeɪnlænd|ˈmenˌlænd, -lənd}-{mainland}-{They have relatives on the mainland}-{n. 大陆； 本土；|adj. 大陆的； 本土的；|,|\
mænˈkaɪnd|ˈmænˌkaɪnd}-{mankind}-{the evolution of mankind.}-{n. 人类； 男性，男子；|,|\
ˌmænjuˈfæktʃə(r)|ˌmænjəˈfæktʃɚ}-{manufacture}-{the company that manufactured the drug ; the methods of manufacture.}-{vt. 制造，生产； 捏造，虚构； 加工； 从事制造|n. 制造； 制成品，产品； 工业，工厂； （文学作品等的）粗制滥造|,|\
məˈri:n|məˈrin}-{marine}-{marine mammals}-{adj. 海的； 海产的； 海军的； 海事的|n. 水兵； 海军陆战队士兵； 海事，海运业；|,|\
mɑ:vɪləs|ˈmɑrvələs}-{marvelous}-{marvelous mystery}-{adj. 引起惊异的； 不可思议的； 非凡的； 神乎其神|,|\
ˈmɑ:ksɪzəm|ˈmɑrksɪzəm}-{Marxism}-{.}-{n. 马克思主义；|,|\
mɑ:ksɪst|'mɑksɪst}-{Marxist}-{.}-{n. 马克思主义者；|adj. 马克思主义的；|,|\
mɑ:sk|mæsk}-{mask}-{a facial mask ;Men often mask their true feelings with humour.}-{n. 面具； 假面具； 用作掩饰的事物； 护肤膜|vt. 掩饰； 戴面具； 用面具遮住，掩盖，掩饰；|vi. 戴面具； 隐瞒，掩饰；|,|\
mæt|mæt}-{mat}-{a letter on the mat}-{n. 席子，垫子； （体育运动用的）厚垫子； 衬边； 团，簇|vt. 遮盖，用垫子作装饰； 使…缠结； 给（照片）镶框； 使…表面无光|vi. 缠结；|adj. 粗糙的； 暗淡的，无光泽的；|,|\
məˈtɪəriəlɪzəm|məˈtɪriəlɪzəm}-{materialism}-{Scientific materialism}-{n. 唯物主义； 唯物论； 实利主义，物质主义； [艺]写实主义|,|\
ˌmæθə'mætɪkl|ˌmæθəˈmætɪkəl}-{mathematical}-{mathematical equation/calculation/formula etc}-{adj. 数学的； 精确的； 绝对的； 可能性极小的|,|\
ˌmæθəˈmætɪks|ˌmæθəˈmætɪks}-{mathematics}-{a professor of mathematics}-{n. 数学； 〈诗〉同“ripen”； 算学；|,|\
meə(r)|ˈmeɪər}-{mayor}-{the new mayor of New York.}-{n. 市长； 镇长； （英格兰、威尔士和北爱尔兰由议员选举产生的）镇长； （民选的）市长|,|\
ˈmi:ntaɪm|ˈminˌtaɪm}-{meantime}-{for the meantime ;meanwhile ; in the meantime}-{n. 其时，其间；|adv. 同时，其间；|,|\
məˈkænɪk|mɪˈkænɪk}-{mechanic}-{take the car to your mechanic.}-{n. 技工，机修工；|,|\
məˈkænɪkl|mɪˈkænɪkəl}-{mechanical}-{a mechanical device}-{adj. 机械的，机械学的； 呆板的； 体力的； 手工操作的|,|\
ˈmedl|ˈmɛdl}-{medal}-{deserve a medal ;Germany has the potential to medal in gymnastics this year.}-{n. 奖章，奖牌； 勋章； 纪念章； 证章|vi. 获奖：赢得一枚奖章；|vt. 授予…奖章；|,|\
melt|mɛlt}-{melt}-{Iron will melt when very hot;My heart just melted when I saw her crying. ;melt into sb’s arms/embrace;meld}-{vi. 熔化，溶解； 逐渐融合； 逐渐消失； 感动，软化，感情上变得温和|vt. 熔化，溶解； 使混合在一起； 逐渐消散； 使变得温和或温柔|,|\
məˈmɔ:riəl|məˈmɔriəl, -ˈmor-}-{memorial}-{memorial service/ceremony ;permanent/lasting memorial to}-{n. 纪念碑，纪念物； 纪念仪式；|adj. 纪念的； 悼念的；|,|\
ˈmeməraɪz|ˈmɛməˌraɪz}-{memorize}-{trying to memorize the way to Rose's street}-{vt. 记住，熟记； [计算机科学] 存储，记忆；|,|\
ˈmɜ:tʃənt|ˈmɜrtʃənt}-{merchant}-{wine/coal/timber etc merchant}-{n. 商人； 批发商； 店主； 零售商|adj. 商人的； 商业的；|,|\
ˈmɜ:si|ˈmɜrsi}-{mercy}-{show mercy to sb}-{n. 宽容； 怜悯； 幸运； 侥幸|,|\
ˈmerɪt|ˈmɛrɪt}-{merit}-{a proposal of some merit}-{n. 价值，优点； [宗教]（行善得到的）功德； 功绩，功勋； 荣誉|vt. 值得，应获得； [宗教]（因行善而）应得（善报）；|vi. 值得，应得； [宗教]积德；|,|\
ˈmeri|ˈmɛri}-{merry}-{the more the merrier ;He marched off, whistling a merry tune.}-{adj. 愉快的，快活的； 有趣的； [口]微醉的； 生动的|n. 甜樱桃； 梅里（姓氏）；|,|\
ˈmetrɪk|ˈmɛtrɪk}-{metric}-{The parts all come in metric sizes now.}-{adj. 米制的，公制的，十进制的； 度量的； 距离的；|n. 度量标准； [数学]度量； 诗体，韵文，诗韵；|,|\
ˈmaɪkrəfəʊn|ˈmaɪkrəfoʊn}-{microphone}-{wireless microphone}-{n. 扩音器，麦克风； 话筒；|,|\
ˈmaɪkrəskəʊp|ˈmaɪkrəskoʊp}-{microscope}-{micro- ;study under a microscope}-{n. 显微镜；|,|\
maɪld|maɪld}-{mild}-{a mild climate}-{adj. 温柔的； 温暖的； 轻微的； （味道）不浓的|n. 淡味麦芽啤酒；|,|\
mɪl|mɪl}-{mill}-{go through the mill ;cotton/steel/paper etc mill}-{n. 磨坊； 磨粉机； 榨汁机； 工厂|vt. 研磨，粉碎； 搅拌； 磨，铣； 轧花边（在纸币上）|vi. 惊跑，乱闯； 经研磨；|,|\
mɪlɪˌmi:tə|'mɪləˌmitə}-{millimeter}-{square millimeter}-{n. 毫米；|,|\
ˈmaɪnəs|ˈmaɪnəs}-{minus}-{17 minus 5 is 12 (17 – 5 = 12). ‘Any minus points ?’ ;pluses and minuses}-{prep. （表示否定）没有； 缺少； （表示运算）减去； （表示数目）在零度以下|n. 减号； 负号； 不利； 不足|adj. 负的； 不利的； 略低于某标准的；|,|\
ˈmɪrəkl|ˈmɪrəkəl}-{miracle}-{a miracle of fortitude 坚韧}-{n. 奇迹，圣迹，神迹； 令人惊奇的人（或事）；|,|\
ˈmɪzrəbl|ˈmɪzərəbəl, ˈmɪzrə-}-{miserable}-{I spent the weekend feeling miserable .}-{adj. 悲惨的； 令人痛苦的； 太少的； 卑鄙的|,|\
ˌmɪsˈli:d|ˌmɪs'lid}-{mislead}-{mislead somebody into believing/thinking etc something}-{vt. 把…带错路； 把…引入歧途；|,|\
ˈmɪsaɪl|ˈmɪsl}-{missile}-{a missile weapon;missile defense system}-{n. 导弹； 投射物；|adj. 导弹的； 可投掷的； 用以发射导弹的；|,|\
ˈmɪsɪŋ|ˈmɪsɪŋ}-{missing}-{missing from ; go missing}-{adj. 失去的； 下落不明的；|v. 错过( miss的现在分词)；|,|\
mɪst|mɪst}-{mist}-{a mist of ;the mist of past}-{n. 薄雾； 视线模糊不清； 液体喷雾；|vt. （使）蒙上薄雾； （使）模糊；|vi. 下雾； 变模糊；|,|\
ˌmɪsʌndəˈstænd|ˌmɪsʌndərˈstænd}-{misunderstand}-{you must have misunderstood her}-{vt. 误会，误解； 曲解；|,|\
ˈmɒdərət|ˈmɑdərət}-{moderate}-{a moderate drinker/price;He learnt to moderate his anger.}-{adj. 有节制的； 稳健的，温和的； 适度的，中等的； <美俚>慢吞吞的|vt. 使和缓； 主持； 节制；|vi. 变缓和； 作主持人；|,|\
ˈmɒdɪst|ˈmɑdɪst}-{modest}-{He was always modest about his role in the Everest expedition.}-{adj. 谦虚的，谦逊的； 适度的，适中的； 端庄的； 羞怯的|,|\
mɔɪst|mɔɪst}-{moist}-{warm moist air}-{adj. 潮湿的； 微湿的； 多雨的； 含泪的|,|\
ˈmɔɪstʃə(r)|ˈmɔɪstʃɚ}-{moisture}-{Plants use their roots to absorb moisture from the soil.}-{n. 水分； 湿气； 潮湿； 降雨量|,|\
ˈmɒlɪkju:l|ˈmɑlɪkjul}-{molecule}-{nicotine is a small molecule}-{n. 分子； 微小颗粒；|,|\
ˈmʌnɪtri|ˈmʌnɪteri}-{monetary}-{objects of little monetary value}-{adj. 货币的，金钱的； 钱的（尤指一国的金融）； 金融的； 财政的，财政（上）的|,|\
məˈnɒpəli|məˈnɑpəli}-{monopoly}-{For years Bell Telephone had a monopoly on telephone services in the US.}-{n. 垄断； 专卖； 垄断者； 专利品|,|\
ˈmɒnjumənt|ˈmɑnjumənt}-{monument}-{a fitting monument to the men who died in the battle}-{n. 纪念碑； 遗迹； 遗址； 丰碑|,|\
məˈræləti|məˈrælɪti, mɔ-}-{morality}-{public/private/personal morality}-{n. 道德； 道德准则； 品德高尚的行为； 道德观|,|\
məˈski:təʊ|məˈskitoʊ}-{mosquito}-{a flying mosquito}-{n. 蚊子；|,|\
mɒs|mɔs}-{moss}-{ground covered over with moss.}-{n. 苔藓； 藓沼； 莫斯（男子名）； 泥炭沼|vt. 以苔藓覆盖； 使长满苔藓；|abbr. [宇](=manned orbital space station)载人轨道航天站；|,|\
ˈməʊtɪveɪt|ˈmoʊtɪveɪt}-{motivate}-{be motivated by}-{vt. 使有动机，促动，激发，诱导； 刺激； 激发…的积极性；|,|\
məʊld|mold}-{mould}-{pour the clay into a mould. Mould the sausage meat into little balls. ;an attempt to mold public opinion}-{n. 铸模； 模型； 性格； 霉|vt. 用模子做； 形成； 陶冶，训练（人格）； 用土覆盖|,|\
maʊnt|maʊnt}-{mount}-{mount a campaign/challenge/search etc ;the cost quickly mounts up.}-{vt.& vi. 登上； 骑上；|vi. 增加； 上升；|vt. 安装，架置； 镶嵌，嵌入； 准备上演； 成立（军队等）|n. 山峰； 攀，登； 运载工具； 底座|,|\
mʌg|mʌɡ}-{mug}-{a coffee mug}-{n. 马克杯，杯子； <口>容易受骗的人； <俚>脸； 一缸子（的量）|vt. 对…行凶抢劫； （尤指在舞台上或摄影机前）扮鬼脸，扮怪相；|,|\
ˈmʌltɪpl|ˈmʌltəpəl}-{multiple}-{Having multiple partners increases your risk of sexual diseases.}-{adj. 多重的； 多个的； 复杂的； 多功能的|n. <数>倍数； [电工学]并联； 连锁商店； 下有多个分社的旅行社|,|\
ˈmʌltɪplaɪ|ˈmʌltəˌplaɪ}-{multiply}-{Multiply the total by 12. ;The amount of information available has multiplied.}-{vt.& vi. 乘； （使）相乘； （使）增加； （使）繁殖|adv. 多样地； 复合地； 多倍地； [电学]并联地，多路地|adj. 多层的； 多样的； 多股的；|,|\
ˈmʌskjələ(r)|ˈmʌskjəlɚ}-{muscular}-{muscular tissue}-{adj. 肌肉的； 壮健的，肌肉发达的，强壮的；|,|\
mjuˈzɪʃn|mjuˈzɪʃən}-{musician}-{a brilliant musician.}-{n. 音乐家；|,|\
ˈmʌtn|ˈmʌtn}-{mutton}-{lamb ;a leg of mutton}-{n. 羊肉； 绵羊；|,|\
mɪˈstɪəriəs|mɪˈstɪriəs}-{mysterious}-{a mysterious letter, parcel}-{adj. 神秘的，诡秘的； 难以理解的，不可思议的； 魔； 玄妙|,|\
mɪθ|mɪθ}-{myth}-{dispel the myth that}-{n. 神话； 神怪故事； 奇人，奇事； 虚构的人，虚构的事|v. 使神话化；|,|\
ˈneɪmli|ˈnemli}-{namely}-{Three students were mentioned, namely John, Sarah and Sylvia.}-{adv. 即，也就是； 换句话说； 亦即； 就是说|,|\
ˌnæʃəˈnæləti|ˌnæʃə'næləti}-{nationality}-{He has British nationality.}-{n. 国籍； 国家； 民族性； 部落|,|\
ˈneɪvl|ˈnevəl}-{naval}-{a naval officer}-{adj. （有）海军的，军舰的，船的；|,|\
ˌnævɪˈgeɪʃn|ˌnævɪˈɡeʃən}-{navigation}-{compasses and other instruments of navigation}-{n. 航行（学）； 航海（术）； 海上交通；|,|\
ˈneɪvi|ˈnevi}-{navy}-{the British Navy}-{n. 海军； 船队；|,|\
nəˈsesəti|nəˈsɛsɪti}-{necessity}-{the basic/bare necessities ;the necessity of (doing) something}-{n. 必要（性）； （迫切）需要； 必需品； 自然规律|,|\
nɪˈglekt|nɪˈɡlɛkt}-{neglect}-{a neglected garden ;years/decades/centuries etc of neglect}-{vt. 疏忽； 忽略； 遗漏； 疏于照顾|n. 玩忽； 被忽略的状态； 怠慢；|,|\
ˈni:grəʊ|ˈnigroʊ}-{Negro}-{a humble Negro girl;I do not accept the Negro as my equal}-{n. 黑种人，黑人；|adj. 黑人的；|,|\
neɪbəhʊd|ˈnebɚˌhʊd}-{neighborhood}-{in the neighbourhood of}-{n. 地区； 某地区的人； 与某处邻近的地区； 临近街坊|,|\
ˈnefju:|ˈnɛfju}-{nephew}-{birthday party for my nephew}-{n. 侄子，外甥；|,|\
nest|nɛst}-{nest}-{leave/fly the nest}-{n. （鸟）窝； 温床； （套叠在一起的）一套物件； 藏匿处|vt. 筑巢； 嵌套；|vi. 筑巢；|,|\
ni:s|nis}-{niece}-{nephew}-{n. 外甥女； 侄女；|,|\
ˈnaɪtmeə(r)|ˈnaɪtmer}-{nightmare}-{the nightmare of going through divorce}-{n. 噩梦； <口>可怕的事情，无法摆脱的恐惧； 泛滥成灾； 紧张|adj. 可怕的，噩梦似的；|,|\
ˈnaɪtrədʒən|ˈnaɪtrədʒən}-{nitrogen}-{liquid nitrogen}-{n. [化]氮，氮气；|,|\
ˈnəʊtəbl|ˈnoʊtəbl}-{notable}-{notable achievement/success/victory}-{adj. 值得注意的； 显著的； 著名的；|n. 名人； 显要人物；|,|\
ˈnəʊtbʊk|ˈnoʊtbʊk}-{notebook}-{He brought out a notebook}-{n. 笔记簿； 笔记本电脑； 手册； 笔记本|,|\
ˈnəʊtɪsəbl|ˈnoʊtɪsəbl}-{noticeable}-{noticeable difference/change/increase etc}-{adj. 显而易见的，明显的； 引人注目的，令人瞩目的； 显著的，重要的； 可以察觉的|,|\
ˈnəʊtɪfaɪ|ˈnoʊtɪfaɪ}-{notify}-{notify somebody of something ;inform}-{vt. 通知； 布告；|,|\
ˈnʌrɪʃ|ˈnɜrɪʃ}-{nourish}-{The cream contains vitamin A to nourish the skin.}-{vt. 滋养，施肥于； 抚养，教养； 怀抱（希望、怨恨）； 使健壮|,|\
ˈnju:kliəs|ˈnukliəs}-{nucleus}-{electron and the nucleus}-{n. 中心，核心； （原子）核； 起点，开始； [微]细胞核|,|\
ˈnɜ:səri|ˈnɜrsəri}-{nursery}-{nursery education/unit/teacher}-{n. 婴儿室，幼儿园； 苗圃； 临时托儿所； 温床，滋生地|,|\
ˈnaɪlɒn|ˈnaɪlɑn}-{nylon}-{made of lightweight nylon}-{n. [纺]尼龙； 尼龙织品； 〈口〉尼龙长袜；|,|\
əˈbeɪ|oˈbe}-{obey}-{obey an order/command}-{vt.& vi. 服从，听从；|vt. 遵守，遵循；|,|\
əˈblaɪdʒ|əˈblaɪdʒ}-{oblige}-{feel obliged to do something ;oblige somebody to do something}-{vt. 强制，强迫； 使负债务； 使感激； 施惠于|vi. 施恩惠； 帮忙，效劳；|,|\
əbˈzɜ:və(r)|əbˈzɜrvə(r)}-{observer}-{political observers}-{n. 遵守者，观察者； 观察团； 观察员；|,|\
ˈɒbstəkl|ˈɑbstəkl}-{obstacle}-{The tax puts obstacles in the way of}-{n. 障碍（物）； 障碍物（绊脚石，障碍栅栏）；|,|\
əˈfend|əˈfɛnd}-{offend}-{be offended by/at something}-{vt. 触怒； 得罪，冒犯； 使反感令人不适；|vi. 犯规，触犯；|,|\
əˈfensɪv|əˈfɛnsɪv}-{offensive}-{crude jokes that are offensive to women}-{adj. 无礼的，冒犯的，唐突的； 讨厌的，令人不快的； 进攻（性）的，攻击的，攻势的；|n. 进攻，攻势；|,|\
ˈɒlɪv|ˈɑlɪv}-{olive}-{an olive grove}-{n. 橄榄； 橄榄树； 橄榄色； 油橄榄|adj. 橄榄色的； 黄褐色的； 淡褐色的； 橄榄绿的|,|\
əˈmɪt|oˈmɪt}-{omit}-{omit to do/doing a piece of work 未做一件工作.}-{vt. 省略； 遗漏； 删掉； 未（做）|,|\
ˈɒprə|ˈɑprə}-{opera}-{an opera singer}-{n. 歌剧； 歌剧艺术， 歌剧业； 作品( opus的名词复数 )； 砌|,|\
ˌɒpəˈreɪʃənl|ˌɑpəˈreɪʃənl}-{operational}-{The new system became operational in March.}-{adj. 即可使用的； （用于）操作的； 经营的； 军事行动的|,|\
ˈɒptɪkl|ˈɑptɪkl}-{optical}-{optical effects;optical instruments}-{adj. 视觉的，视力的； 眼睛的； 光学的；|,|\
ˈɒptɪməl|ˈɑptɪməl}-{optimal}-{near optimal 近似最佳;optimum}-{adj. 最佳的，最优的； 最理想的；|,|\
ˌɒptɪˈmɪstɪk|ˌɑptɪˈmɪstɪk}-{optimistic}-{We are still relatively optimistic that ;an optimistic estimate}-{adj. 乐观的，乐观主义的；|,|\
ˈɔ:rəl|ˈɔrəl}-{oral}-{an oral agreement}-{adj. 口头的，口述的； 口服的； 属于或关于嘴的； 构成或使用言语的|n. （尤指外语考试中的）口试；|,|\
ˈɔ:bɪt|ˈɔrbɪt}-{orbit}-{The satellite orbits the Earth every 48 hours. ;within the orbit of something}-{n. 轨道； 势力范围； 眼眶； （人生的）旅程，生活过程|vt.& vi. 在…轨道上运行，环绕轨道运行；|vi. 盘旋； 绕轨道运行；|vt. 绕轨道而行； 进入轨道；|,|\
ˈɔ:kɪstrə|ˈɔrkɪstrə}-{orchestra}-{the school orchestra}-{n. 管弦乐队； 管弦乐队的全部乐器；|,|\
ˈɔ:dəli|ˈɔrdərli}-{orderly}-{in a more orderly way.}-{adj. 整齐的，有秩序的； 有组织的，有规则的； [军]值班的； 安静的|n. [军]传令下士； 传令兵； <英>街道清洁工；|adv. 依次地，顺序地； 有规则地； 有条理地；|,|\
ɔ:(r)|ɔr, or}-{ore}-{iron ore}-{n. 矿； 矿石，矿砂；|,|\
ˈɔ:gənɪzəm|ˈɔrgənɪzəm}-{organism}-{All living organisms}-{n. 有机体； 生物体； 微生物； 有机体系，有机组织|,|\
ˈaʊtdɔ:(r)|ˈaʊtˌdɔr, -ˌdor}-{outdoor}-{outdoor clothing}-{adj. 户外的，露天的； 喜欢户外活动的； （医院等）院外的； 室外|,|\
ˈaʊtə(r)|ˈaʊtɚ}-{outer}-{the outer suburbs}-{adj. 外面的，外部的； 远离内部（中心）的； [哲]客观外界的，物质的；|n. 环外命中；|,|\
ˈaʊtlet|ˈaʊtˌlɛt, -lɪt}-{outlet}-{the outlet of a lake 湖的出水口}-{n. 出口，出路； 批发商店； 排水口，通风口； 发泄（情感）的方法|,|\
ˈaʊtlaɪn|ˈaʊtˌlaɪn}-{outline}-{an outline of world history ;outline plans}-{n. 梗概，大纲，提纲，草稿，要点，主要原则； 外形，轮廓，轮廓线，轮廓画法，略图（画法）；|vt. 概述； 略述； 画轮廓，打草图，描略图；|,|\
ˈaʊtlʊk|ˈaʊtˌlʊk}-{outlook}-{a positive outlook}-{n. 前景，展望； 观点，见解； 景色； 眺望处|v. 瞪着看，瞧； 比…漂亮； 用目光压倒；|,|\
ˈaʊtset|ˈaʊtˌsɛt}-{outset}-{at/from the outset of}-{n. 开始，开端；|,|\
ˈaʊtwədz|ˈaʊtwərdz}-{outwards}-{The door opens outwards. ;facing/looking/spreading etc outwards}-{adv. 向外地； 外表地；|,|\
ˈəʊvl|ˈoʊvl}-{oval}-{an oval mirror;elliptical}-{adj. 椭圆形的； 卵形的；|n. 椭圆形； 椭圆运动场（等）； 椭圆，美式足球用球； [物]卵形线|,|\
ˌəʊvəˈhed|ˌoʊvərˈhed}-{overhead}-{A plane flew overhead. the overheads are very high ;}-{adj. 上面的，高架的； 头顶上的； （费用等）经常的，管理的；|n. 天花板； 管理费用，经常费用； 船舱的顶板； [体]（网球等的）扣杀|adv. 在头顶上； 在空中； 在楼上； 向上|,|\
ˌəʊvəˈlʊk|ˌoʊvərˈlʊk}-{overlook}-{overlook the fact that ;Our room overlooks the ocean.}-{vt. 忽视，忽略； 瞭望； 检查； 远眺|n. 从高处眺望到的景色； 忽视，忽略； 可眺望四周的高地；|,|\
ˌəʊvəˈnaɪt|ˌoʊvərˈnaɪt}-{overnight}-{happen/appear/change overnight ;an overnight success.}-{adv. 在晚上； 在夜里； 突然； 很快|adj. 一整夜的； 晚上的； 突然的； 很快的|n. 前一天的晚上； 一夜的逗留；|vi. 过一夜；|,|\
ˌəʊvəˈteɪk|ˌoʊvərˈteɪk}-{overtake}-{The car overtook the truck.;The diplomatic negotiations were soon overtaken by events.}-{vt. 追上，赶上； 压倒； （不愉快的事）突然降临；|,|\
ˌəʊvəˈwelm|ˌoʊvərˈwelm}-{overwhelm}-{The small craft was overwhelmed by the enormous waves.}-{vt. 淹没； 压倒； 覆盖； 压垮|,|\
ˌəʊvəˈwelmɪŋ|ˌoʊvərˈwelmɪŋ}-{overwhelming}-{She felt an overwhelming desire to hit him.}-{adj. 势不可挡的，压倒一切的，巨大的； 压倒一切的欢乐；|,|\
ˈəʊɪŋ|ˈoʊɪŋ}-{owing}-{You need to pay the amount owing, plus the interest. ;Owing to a lack of funds,}-{adj. 欠着的，应付的，未付的；|v. 感激( owe的现在分词 )； 应把…归功于； 欠…债； （对位高权重者）忠诚|,|\
aʊl|aʊl}-{owl}-{owl eyes;A great owl}-{n. 猫头鹰； 惯于晚上活动的人； 夜猫子； （像猫头鹰一样）机警的人|,|\
ɒks|ɑks}-{ox}-{cow or bull}-{n. 牛，公牛； 牛属动物；|,|\
ˈɒksɪdʒən|ˈɑksɪdʒən}-{oxygen}-{without oxygen}-{n. [化]氧，氧气；|,|\
ˈpeɪnfl|ˈpenfəl}-{painful}-{painful to do something ;painful memories/experience etc}-{adj. 痛苦的； （肉体）疼的； 费力的，（工作）困难的； 讨厌的，使人厌烦的|,|\
ˈpeɪntə(r)|ˈpentɚ}-{painter}-{a painter and decorator}-{n. 画家，着色者； 油漆匠； （系船的）缆绳； 破诡计|,|\
pɑ:m|pɑm}-{palm}-{She looked at the coins in her palm.}-{n. 手掌； 手心； 棕榈树 ； 由Palm公司发明的一种PDA上的操作系统|v. 将…藏于掌中；|,|\
pænt|pænt}-{pant}-{pant heavily as he run}-{n. 喘气，喘息； 气喘； 喷气声；|vi. 喘气，喘息； 喘着气说，气喘吁吁地讲； 热望，渴望，想； （机车等）喷气|vt. 气喘；|,|\
ˈpeɪpəbæk|ˈpeɪpərbæk}-{paperback}-{20,000 copies in paperback.}-{n. 平装本，平装书；|,|\
pəˈreɪd|pəˈred}-{parade}-{a victory parade ;parade around/past etc}-{v. 游行； 展览； 招摇过市； 接受检阅|n. 检阅； 游行； 一系列； 炫耀|,|\
ˈpɑ:ʃl|ˈpɑrʃl}-{partial}-{I’m very partial to cream cakes. ;a partial success.}-{adj. 部分的； 偏爱的； 偏袒的； 钟爱的|n. [数学]偏微商；|,|\
ˈpɑ:tɪkl|ˈpɑrtɪkl}-{particle}-{There's not a particle of truth in her story.}-{n. 微粒，颗粒； [数，物]粒子，质点； 极小量； 小品词|,|\
ˈpɑ:spɔ:t|ˈpæspɔrt}-{passport}-{You should take your passport with you}-{n. 护照，通行证； 手段；|,|\
peɪst|pest}-{paste}-{wallpaper paste}-{n. 面团； 糨糊； 肉（或鱼等）酱（作涂抹料或烹饪用）； （制作人造宝石的）铅质玻璃|vt. 粘贴，张贴； 以…覆盖于；|,|\
pæt|pæt}-{pat}-{pat somebody/yourself on the back}-{vt.& vi. 轻拍，爱抚； 拍成，拍至；|n. 轻拍； 轻拍某物发出的声音； 小团，小块；|adj. 恰好的，适当的； 熟练的； 过于巧合的，人为的； 快活的，活泼的|vt. 表扬，称赞（某人/自己）；|,|\
pætʃ|pætʃ}-{patch}-{a patch of grass ;A new plan was quickly patched together.}-{n. 补丁，补片； 眼罩； 斑点； 小块|vt. 修补，拼凑； 暂时遮掩一下； 修理，平息（吵架等）； 用美人斑装饰（脸）|vi. 打补丁；|,|\
pɔ:|pɔ}-{paw}-{a lion’s paw}-{n. 爪子； 手； <俚>笔迹；|vt. 用爪抓； 用蹄触； 盘弄； 艰苦地行走|vi. 用爪子抓； 翻找；|,|\
pi:|pi}-{pea}-{green pea}-{n. 豌豆，豌豆类； 豌豆状物； 〈美俚〉棒球；|,|\
pi:tʃ|pitʃ}-{peach}-{a peaches and cream complexion ;}-{n. 桃子； 桃红色； 极好的人（或物）；|adj. 桃红色的； 粉红色的；|,|\
peə(r)|per}-{pear}-{I took this apple for a pear}-{n. 梨（树）； 梨树；|,|\
pɜ:l|pɜrl}-{pearl}-{She wore a string of pearls}-{n. 珍珠； 珍品； 人造珍珠； 珠状物|vi. 采珍珠；|vt. 使成珠状； 用珍珠装饰；|,|\
pɪˈkju:liə(r)|pɪˈkjuljɚ}-{peculiar}-{It seems very peculiar that ;She’s a very peculiar child.}-{adj. 奇怪的，古怪的； 异常的； 特有的，特殊的；|n. 专有特权，专有财产； [多用于英国]特殊教堂；|,|\
pəˈdestriən|pəˈdɛstriən}-{pedestrian}-{be pretty pedestrian;motorist ;a pedestrian walkway}-{n. 步行者； 行人；|adj. 徒步的； 平淡无奇的； 一般的；|,|\
pɪə(r)|pɪr}-{peer}-{peer at a secret document;their peers in Japan}-{vi. 凝视； 盯着看； 隐退，若隐若现； 同等，比得上|n. 同辈，同等的人； 贵族； 同伴，伙伴；|adj. 贵族的； （年龄、地位等）同等的； 相匹敌的；|,|\
ˈpenɪtreɪt|ˈpɛnɪˌtret}-{penetrate}-{penetrate into}-{vt. 穿透，刺入； 渗入； 秘密潜入； 洞悉，明了|vi. 穿透，穿过； 进入，渗入； 洞悉；|,|\
pəˈmɪsəbl|pərˈmɪsəbl}-{permissible}-{the maximum permissible level of radiation}-{adj. 可允许的； 许可的； 不碍事的； 得到准许的|,|\
ˌpesɪˈmɪstɪk|ˌpesɪˈmɪstɪk}-{pessimistic}-{pessimistic about ;a pessimistic view of life}-{adj. 悲观的，厌世的； 悲观主义的；|,|\
pest|pɛst}-{pest}-{a chemical used in pest control ;vermin}-{n. 讨厌的人或事； 有害动植物； 瘟疫；|,|\
pəˈtrəʊliəm|pəˈtroʊliəm}-{petroleum}-{petroleum-based products}-{n. 石油；|,|\
fɪˈzɪʃn|fɪˈzɪʃən}-{physician}-{your family physician}-{n. 医生，内科医生； <口>医学博士； （精神创伤的）医治者，抚慰者；|,|\
ˈfɪzɪsɪst|ˈfɪzɪsɪst}-{physicist}-{a nuclear physicist.}-{n. 物理学家； 唯物论者； <古>自然科学家； 宇宙机械论者|,|\
ˌfɪzɪə'lɒdʒɪkl|ˌfɪziəˈlɑdʒɪkəl}-{physiological}-{physiological need;physiological saline}-{adj. 生理学的； 生理的；|,|\
pɪəs|pɪrs}-{pierce}-{pierce through sth}-{vt. 刺穿，戳穿； 刺破； 洞察； 深深打动|vi. 进入； 透入；|,|\
ˈpɪdʒɪn|ˈpɪdʒən}-{pigeon}-{Grey Pigeon}-{n. 鸽子； <非正式>易受骗的人； <非正式>责任；|,|\
ˈpɪlə(r)|ˈpɪlɚ}-{pillar}-{Christine’s been a pillar of strength to me.}-{n. 柱，台柱，顶梁柱； 墩，柱脚； （组织、制度、信仰等的）核心；|,|\
ˈpɪləʊ|ˈpɪloʊ}-{pillow}-{hit the pillow.}-{n. 枕头； 垫子； 花边垫子；|vt. 搁于枕上； 当作枕头用；|vi. 以…为枕；|,|\
pɪntʃ|pɪntʃ}-{pinch}-{He pinched her cheek.}-{vt. 捏，掐； 挤痛，夹痛； 使（植物）枯萎，凋谢； 使紧缺，节制|vi. 挤痛，压痛； 吝惜，节约；|n. 匮乏； 少量，一撮； 困苦；|,|\
paɪn|paɪn}-{pine}-{pine away ;pine for somebody/something}-{n. 松树； 松木； 凤梨，菠萝；|vi. 憔悴； 痛苦； 渴望；|vt. 为…悲哀； 哀悼； 消瘦； 渴望，渴慕|adj. 似松的； 松木的；|,|\
pɪt|pɪt}-{pit}-{a five-foot deep pit}-{n. 井； 煤矿； 麻子； （赛车道旁的）修理加油站|vt. 使有麻子； 使有凹陷；|vi. 凹陷； 起凹点；|,|\
pleɪg|pleɡ}-{plague}-{a plague of rats/locusts etc ;be plagued by/with something}-{n. 瘟疫； 灾害，折磨；|vt. 使染瘟疫； 使痛苦，造成麻烦；|,|\
plɑ:nˈteɪʃn|plænˈteɪʃn}-{plantation}-{a plantation of almond trees}-{n. 种植园，大农场； 栽植； <史>殖民，殖民地；|,|\
pledʒ|plɛdʒ}-{pledge}-{give a pledge never to reveal the secret;pledge to do something}-{n. 保证，誓言； [法]抵押权； 公约； （表示友谊的）干杯|vt.& vi. 使发誓，保证； 典当，抵押；|vt. 许诺； 用…担保； 以誓言约束； 向…祝酒|vi. 作出庄重有约束力的誓言； 祝愿，祝酒；|,|\
ˈplentɪfl|ˈplɛntɪfəl}-{plentiful}-{a plentiful supply of food}-{adj. 丰富的； 富产的； 丰饶的； 充沛|,|\
plʌndʒ|plʌndʒ}-{plunge}-{plunge sth into sth}-{vt. 用力插入； 使陷入；|vi. 跳入； 全心投入； 突降，俯冲；|n. 投入，陷入； 游泳，跳水；|,|\
ˈplʊərəl|ˈplʊrəl}-{plural}-{a plural society.}-{adj. 复数的；|n. 复数； 复数形式； 复数词；|,|\
ˈpɔɪzn|ˈpɔɪzən}-{poison}-{rat poison ;poison somebody with something}-{n. 毒药； 酒； 极糟的食物； 极有害的思想（或心情等）|vt. 毒死； 污染； 放毒于； 对…有不良影响|adj. 有毒的；|,|\
ˈpɔɪzənəs|ˈpɔɪzənəs}-{poisonous}-{The berries are poisonous to birds.}-{adj. 有毒的； 有害的； 恶意的； <口>讨厌的|,|\
ˈpɒlɪʃ|ˈpɑlɪʃ}-{polish}-{Polish the lenses with a piece of tissue.}-{v. 擦光； 磨光； 修改； 润色|n. 光泽剂，擦亮剂； 擦亮，磨光； 优美，优雅，精良；|,|\
pəˈlu:t|pəˈlut}-{pollute}-{pollute something with something ;heavily/severely/badly etc polluted}-{vt. 污染； 玷污，亵渎； 破坏（品性），使堕落；|,|\
ˈpɔ:təbl|ˈpɔrtəbl}-{portable}-{a portable radio}-{adj. 手提的； 轻便的；|n. 手提式打字机；|,|\
ˈpɔ:tə(r)|ˈpɔrtə(r)}-{porter}-{tip the porter;a porter to help her with the heavy luggage}-{n. 门童； 搬运工人； （医院里护送病人的）护工； （尤指卧铺车厢的）列车服务员|,|\
ˈpɔ:treɪt|ˈpɔrtrət}-{portrait}-{a family portrait}-{n. 肖像，肖像画； 模型，标本； 半身雕塑像； 人物描写|,|\
ˈpəʊstɪdʒ|ˈpoʊstɪdʒ}-{postage}-{postage and packing}-{n. 邮费，邮资；|,|\
pəˈspəʊn|poʊˈspoʊn}-{postpone}-{postpone sth to/for}-{vt. 使延期，延缓； 把…放在次要地位； 把…放在后面；|vi. 延缓； 延缓发作；|,|\
ˈpaʊdə(r)|ˈpaʊdɚ}-{powder}-{talcum powder}-{n. 粉，粉末； 粉状物质；|vt. 在…搽粉；|vi. 涂粉，变成粉末；|,|\
pri:tʃ|pritʃ}-{preach}-{preach about/on}-{vt.& vi. 布道，讲道； 宣扬； 说教； 讲（道）|n. 〈口〉讲道，说教；|,|\
prɪˈkɔ:ʃn|prɪˈkɔʃən}-{precaution}-{a precaution for}-{n. 预防，防备，警惕； 预防措施； 避孕措施；|vt. 使提防； 预先警告；|,|\
ˈpreʃəs|ˈprɛʃəs}-{precious}-{precious seconds/minutes/hours/time}-{adj. 宝贵的，珍贵的； 贵重的； 矫揉造作的； 可爱的，宝贝的|adv. <口>很，非常；|n. 珍爱的人； 可爱的人；|,|\
ˈprefəs|ˈprefəs}-{preface}-{The book is prefaced by a quotation from Faulkner.;prologue;preamble;}-{n. 序言，引语； 开端，前奏； [宗]（弥撒的）序诵，序祷；|vi.&vt. 作为…的序言，作为…的开端； 作序； 给…作序； 开始，导致|,|\
ˈprefrəbl|ˈprɛfərəbəl, ˈprɛfrə-}-{preferable}-{coffee is preferable to tea}-{adj. 更好的，更可取的； 略胜一筹的；|,|\
ˈpredʒudɪs|ˈprɛdʒədɪs}-{prejudice}-{racial/sexual prejudice ;A criminal record will prejudice your chances of getting a job.;jaundice}-{n. 成见，偏见，歧视； 侵害； 伤害；|vt. 使有偏见； 不利于，损害；|,|\
ˈpremətʃə(r)|ˌpriməˈtʃʊr}-{premature}-{it is premature (for somebody) to do something;precocious}-{adj. 过早的； 提前的； 早产的； 草率的|n. 早产儿；|,|\
ˈpremiə(r)|prɪˈmɪr}-{premier}-{the Irish Premier ;one of Dublin’s premier hotels}-{n. 总理； 首相；|adj. 第一的，首位的； 首要的； 最先的； 最早的|,|\
ˌprepəˈzɪʃn|ˌprɛpəˈzɪʃən}-{preposition}-{Compound Preposition;position}-{n. 介词； 前置词；|,|\
prɪˈskraɪb|prɪˈskraɪb}-{prescribe}-{prescribe you something stronger.;scribe}-{vt. 指定，规定； 指定，规定；|vi. 建立规定，法律或指示； 开处方，给医嘱；|,|\
prɪˈskrɪpʃn|prɪˈskrɪpʃən}-{prescription}-{scription a prescription for pain-killers}-{n. [医]药方，处方； 处方药； 训令，指示； 法规|,|\
ˈprezntli|ˈprɛzəntli}-{presently}-{Presently, I fell asleep.}-{adv. 目前； 不久； 马上；|,|\
preˈsti:ʒ|prɛˈstiʒ, -ˈstidʒ}-{prestige}-{regain prestige;reputation}-{n. 威信，威望，声望； 声誉； （财势的）显赫； 信望|,|\
prɪˈveɪl|prɪˈvel}-{prevail}-{prevail in the region}-{vi. 流行，盛行； 获胜，占优势； 说服，劝说；|,|\
ˈprevələnt|ˈprɛvələnt}-{prevalent}-{prevalent in/among etc}-{adj. 流行的，盛行的； 普遍存在的，普遍发生的；|,|\
ˈprɪmətɪv|ˈprɪmɪtɪv}-{primitive}-{a primitive society}-{adj. 原始的； 发展水平低的； 落后的； [生物学]原生的|n. 原始人； 早期的艺术家（作品）； 单纯的人：不世故的人； 自学的艺术家|,|\
ˈprɒbəbl|ˈprɑbəbl}-{probable}-{probable outcome/consequence/result}-{adj. 可能的； 大概的；|n. 很可能的事； 可能入选者；|,|\
prəˈseʃn|prəˈsɛʃən}-{procession}-{an endless procession of visitors}-{n. 队伍，行列； 一列，一排； 列队行进；|vi. 排队前进或列队而行；|,|\
prəˈdʌktɪv|prəˈdʌktɪv, pro-}-{productive}-{a highly productive meeting}-{adj. 富有成效的； 多产的； 生产性的； 具有创造性的|,|\
ˌprɒdʌkˈtɪvəti|ˌprɑdʌkˈtɪvəti}-{productivity}-{increase/improve/raise productivity}-{n. 生产率，生产力； [经济学] 生产率； [生态学]生产率；|,|\
prəˈfes|prəˈfɛs, pro-}-{profess}-{profess medicine. 行医 profess ignorance 假称不知;profess to do/be something}-{vt. 声称； 宣称； 公开表明； 信奉|,|\
ˈprɒfɪtəbl|ˈprɑfɪtəbl}-{profitable}-{a highly profitable business}-{adj. 有利可图的，有益的； 可赚钱的，合算的；|,|\
prəˈfaʊnd|prəˈfaʊnd, pro-}-{profound}-{take a profound interest in sth}-{adj. 深厚的； 意义深远的； 严重的； 知识渊博的|n. 〈诗〉深海，大洋； 深渊； （灵魂）深处；|,|\
prəˈgresɪv|prəˈɡrɛsɪv}-{progressive}-{progressive and forward-looking policies}-{adj. 不断前进的； 进步的； 进行的；|n. 改革论者； 进步分子；|,|\
ˈprɒmɪnənt|ˈprɑmɪnənt}-{prominent}-{play a prominent part in public life}-{adj. 突出的，杰出的； 突起的； 著名的；|,|\
ˈprəʊnaʊn|ˈproʊnaʊn}-{pronoun}-{noun}-{n. <语>代词；|,|\
prɒˈsperəti|prɑˈsperəti}-{prosperity}-{a time of economic prosperity}-{n. 繁荣； 兴旺，昌盛； 成功；|,|\
ˈprɒspərəs|ˈprɑspərəs}-{prosperous}-{a prosperous country}-{adj. 繁荣的，兴旺的； 富裕的； 幸福的，运气好的； 良好的|,|\
prəˈtektɪv|prəˈtɛktɪv}-{protective}-{protective tariffs}-{adj. 保护的，防护的； 保护贸易的；|,|\
ˈprəʊti:n|ˈproʊtin}-{protein}-{the protein of the egg}-{n. [化]朊，蛋白（质）；|adj. 蛋白质的；|,|\
ˈprɒvɪns|ˈprɑvɪns}-{province}-{southernmost province}-{n. 省份； 大行政区； 范围； 职责|,|\
prəˈvəʊk|prəˈvoʊk}-{provoke}-{provoke a protest/an outcry/criticism etc}-{vt. 激起，挑起； 煽动； 招致； 触怒，使愤怒|,|\
pʌls|pʌls}-{pulse}-{check/feel somebody's pulse}-{n. 脉搏； [无线电]（电磁波等）脉动； 活力； 有节奏的跳动（或拍打）|vi. （心脏）跳动； 脉动； 搏动； 震动|vt. 使跳动； 有节奏地驱动（机器等）； [电子学]施以脉冲； [无线电]脉冲地调节（电磁波）|,|\
}-{pump}-{a petral汽油 pump;pump floodwater out of the cellars.}-{n. 抽水机； 打气筒； 泵； 轻软舞鞋|v.  用泵输送 ； 涌出； 急速摇晃； 盘问|,|\
ˈpʌmpkɪn|ˈpʌmpkɪn, ˈpʌm-, ˈpʌŋ-}-{pumpkin}-{Quarter the pumpkin}-{n. 南瓜； 南瓜的果肉，南瓜囊； 〈俚〉重要人物；|,|\
ˈpʌŋktʃuəl|ˈpʌŋktʃuəl}-{punctual}-{a punctual start to the meeting}-{adj. 严守时刻的， 准时的，正点的；|,|\
ˈpjʊərəti|ˈpjʊrəti}-{purity}-{the purity of water}-{n. [化学]纯度； 纯洁，纯净； 清洁，清白，清廉； （语言）纯正|,|\
ˈpʌzl|ˈpʌzəl}-{puzzle}-{the puzzle of how the sun works ;The class puzzled over a poem}-{vt. 使迷惑，使难解；|vt.& vi. 为难，伤脑筋；|n. 智力测验，智力玩具； 难题； 令人费解的事[人]； 谜一般的事物|,|\
kwest|kwɛst}-{quest}-{in quest of something ; quest for}-{n. 探索； 追求； 远征； 验尸陪审团|vt. 寻找； 探索；|vi. 进行探求； （猎犬等）跟踪搜寻；|,|\
kwɪz|kwɪz}-{quiz}-{a general knowledge quiz ;quiz somebody about something}-{n. 提问，询问； 小型考试； 简单的小测验； 恶作剧|vt. 盘问； 挖苦； 进行测试； 张望|,|\
ˈræbɪt|ˈræbɪt}-{rabbit}-{a robust rabbit}-{n. 兔子，野兔； 兔子皮毛； 兔子肉； 〈俚〉新手，弱手|vi. 猎兔（通常作 go rabbiting）； （兔子似的）聚拢在一起； <英俚>唠叨，喋喋不休（常与on about连用）；|vt. 让…见鬼去吧；|,|\
ˈreɪʃl|ˈreʃəl}-{racial}-{racial discrimination}-{adj. 种族的； 人种的； 存在或发生于种族之间的；|,|\
ræk|ræk}-{rack}-{a magazine rack ;Liza was racked by guilt.}-{n. 行李架； 支架； 刑架； （羊、猪等带前肋的）颈脊|vt. 使痛苦，使焦虑； 剥削，榨取； 用刑拘折磨；|,|\
ˈreɪdɑ:(r)|ˈredɑr}-{radar}-{Enemy planes were picked up by our radar}-{n. 雷达； 雷达装置； 无线电探测器；|,|\
ˌreɪdiˈeɪʃn|ˌrediˈeʃən}-{radiation}-{a lethal dose of radiation}-{n. 辐射； 放射物； 辐射状； 分散|,|\
ræg|ræɡ}-{rag}-{in rags ; from rags to riches}-{n. 破布； 碎布； 破旧衣服； 碎片|vt. 嘲笑，捉弄； 糟蹋，欺负； 指责，欺负人；|,|\
reɪdʒ|reɪdʒ}-{rage}-{red/dark/purple with rage ;He was sorry he had raged at her earlier.}-{n. 愤怒； 激烈，猛烈； 渴望，疯狂； 〈口〉战争狂|vi. 大发脾气，动怒； 流行，风行；|,|\
reɪd|red}-{raid}-{launch/carry out/stage a raid ; they raided his home.}-{n. （骑兵队等的）急袭，突然袭击，突击，（军舰等的）游击； 劫掠，劫夺，（盗贼，狐等的）侵入； 突然查抄[搜捕]，围捕；|vi. 对…进行突然袭击； 进行奇袭；|vt. 突然袭击[抢劫]； 突然搜查； 劫掠； 打劫|,|\
ˈreɪlrəʊd|ˈreɪlroʊd}-{railroad}-{The railroad connects two cities}-{n. 铁路，铁道； 铁路系统，铁路公司；|v. 迫使…仓促行事； 强使…草率通过 ； 强迫…做； 轻率判处|,|\
ˈreɪnbəʊ|ˈreɪnboʊ}-{rainbow}-{bow 弓}-{n. 彩虹；|adj. 五彩缤纷的； 彩虹状的；|vt.&vi. 使呈彩虹状；|,|\
ˈræli|ˈræli}-{rally}-{an attempt to rally support for the party}-{vt. 召集，集合； 重整； 重振，恢复；|vi. 聚集； 集合； 反弹，反败为胜； 恢复（元气等）|n. 集合； 重新集合； 重整的信号； 反败为胜|,|\
ræp|ræp}-{rap}-{a sharp rap on the door. ;Angrily she rapped on his window}-{vt.& vi. 突然说出； （公开地）严厉批评； 突然大声说出； 连续敲叩|n. （轻快的）敲击（声）； 说唱音乐； 说唱歌； 速度快的谈话|,|\
ræt|ræt}-{rat}-{rats and cats;}-{n. 大老鼠； 似鼠动物； <非正式>鼠辈，卑鄙小人；|vi. 捕鼠； <俚>背叛，告密；|,|\
relm|rɛlm}-{realm}-{in the realm of science}-{n. 领域，范围； 王国； （学术的）部门，界； （动植物分布的）圈，带|,|\
rɪə(r)|rɪr}-{rear}-{the rear of the hall.}-{vt. 饲养； 养育； 抚养； 养育|vt.& vi. 抬起；|n. 后部，背面，背后； 臀部； （舰队或军队的）后方，后尾，殿后部队； 〈英口〉厕所|vi. 直立； 高耸；|adj. 后面的，后部的；|,|\
ˈrebl| rɪˈbɛl}-{rebel}-{Anti-government rebels ;rebel against}-{n. 反政府的人； 反叛者； 造反者； 叛逆者|adj. 反抗的； 造反的；|,|\
rɪˈsi:və(r)|rɪˈsivɚ}-{receiver}-{She picked up the receiver and started to dial}-{n. 接受者，收款员； 接收器； 无线电接收机； （破产公司的）官方接管人|,|\
rɪˈseʃn|rɪˈsɛʃən}-{recession}-{into/out of recession}-{n. 经济衰退，不景气； 后退，撤退； 凹处； 退场|,|\
rɪˈsaɪt|rɪˈsaɪt}-{recite}-{recite a speech}-{vt.& vi. 背诵； 叙述； 列举；|vt. 详述，列举； 吟诵；|vi. 背诵； 叙述；|,|\
ˈrekənsaɪl|ˈrɛkənˌsaɪl}-{reconcile}-{reconcile with sb}-{vt. 使和好，使和解； 调停，排解（争端等）； [宗]使（场所等）洁净； [船]使（木板）接缝平滑|,|\
rɪˈkɔ:də(r)|rɪˈkɔrdə(r)}-{recorder}-{put the recorder on the desk}-{n. 录音机； 直笛； 记录员； 刑事法院法官|,|\
ˌrekriˈeɪʃn|ˌrɛkriˈeʃən}-{recreation}-{recreate; recreation facilities}-{n. 消遣（方式）； 娱乐（方式）； 重建，重现；|,|\
rɪˈkru:t|rɪˈkrut}-{recruit}-{recruit enough qualified staff. ;recruit somebody to do something}-{n. 新兵； （机构中的）新成员； 新学生；|vt. 招聘，征募； 吸收某人为新成员； 动员…（提供帮助）； 雇用|vi. 征募新兵； 得到补充，得到补偿； 恢复健康；|,|\
ˌri:ˈsaɪkl|riˈsaɪkəl}-{recycle}-{We take all our bottles to be recycled.}-{vt. 回收利用； 使再循环；|vi. 重复利用；|,|\
ˌrefəˈri:|ˌrɛfəˈri}-{referee}-{act as his referee.;refer}-{n. 裁判员； 证明人； 公断人； （专业性强的文章的）审阅人|vi. 担任裁判；|vt. 审阅，鉴定（专业性强的文章）； 为…当裁判； 仲裁判定；|,|\
rɪˈfreʃ|rɪˈfrɛʃ}-{refresh}-{refresh sb’s memory}-{vt. 使恢复，使振作； 使焕然一新，翻新； 给（电池）充电；|vi. 恢复精神； 补充给养；|,|\
ˈrefju:dʒ|ˈrɛfjudʒ}-{refuge}-{take/seek refuge (in something)}-{n. 避难； 避难所； 庇护者； [医]救急疗法|vt. 给予…庇护； 接纳…避难；|vi. 躲避； 避难；|,|\
ˌrefjuˈdʒi:|ˌrɛfjʊˈdʒi}-{refugee}-{refugee camps;refuge}-{n. 避难者，难民；|,|\
rɪˈfju:zl|rɪˈfjuzəl}-{refusal}-{refusal to do something ;refusal of}-{n. 拒绝； 优先取舍权；|,|\
rɪˈgɑ:dɪŋ|rɪˈgɑrdɪŋ}-{regarding}-{Regarding your recent inquiry ;concerning , with regard to}-{prep. 关于； 就…而论； 至于；|v. regard的现在分词；|,|\
rɪˈgɑ:dləs|rɪˈgɑrdləs}-{regardless}-{regardless of race, religion, or sex.}-{adv. 不顾后果地； 不管怎样，无论如何； 不惜费用地；|adj. 不重视的，不尊敬的； 不顾虑的，不关心的； 不受注意的，毫无价值的；|,|\
ˌreləˈtɪvəti|ˌrɛləˈtɪvɪti}-{relativity}-{theory of relativity}-{n. <物>相对论； 相关性； 相对性；|,|\
ˈri:leɪ|'rileɪ}-{relay}-{relay the message to the boss}-{n. 接替人员，替班； 传递； 接力赛； 继电器|vt. 转播，传达； 用驿马递送，使接替； 分程传递；|,|\
ˈremədi|ˈrɛmɪdi,'rɛmədɪ}-{remedy}-{seek a remedy for}-{n. 治疗法； 补救办法； 纠正办法； （硬币的）公差|vt. 改正，纠正，改进； 补救； 治疗；|,|\
ˈrendə(r)|ˈrɛndɚ}-{render}-{render a decision/opinion/judgment etc ;render something into English ;}-{v. 使成为； 递交； 给予； 表达|,|\
rɪˈnju:|rɪˈnu}-{renew}-{renew sb’s contract/licence/membership etc}-{vt. 重新开始； 使更新； 使恢复； 补充|vi. 重申，重复强调； 重新开始；|,|\
rɪ'pi:tɪdlɪ|rɪ'pitɪdlɪ}-{repeatedly}-{Graham was repeatedly warned not to work so hard.}-{adv. 反复地，重复地； 再三地； 屡次地； 不停地|,|\
ˈrepətwɑ:(r)|ˈrepərtwɑ(r)}-{repertoire}-{a wide repertoire of songs}-{n. 全部节目； 全部本领； （计算机的）指令表；|,|\
ˌrepəˈtɪʃn|ˌrɛpɪˈtɪʃən}-{repetition}-{learn by repetition petition}-{n. 重复，反复； 背诵； 复制品，副本； [乐]复唱，复奏，重奏|,|\
ˌri:prəˈdju:s|ˌriprəˈdus}-{reproduce}-{The turtles return to the coast to reproduce. ;unable to reproduce}-{vt.& vi. 复制，重现，再版； 生殖，繁殖；|vt. 使再次发生； 再现；|,|\
rɪˈpʌblɪkən|rɪˈpʌblɪkən}-{republican}-{a Democrat or a Republican}-{adj. 共和国的； 共和政体的； 共和主义的； <美>共和党员|n. 拥护共和政体者，共和主义者； <美>共和党的；|,|\
rɪˈzembl|rɪˈzɛmbəl}-{resemble}-{He grew up to resemble his father.}-{vt. 与…相像，类似于；|,|\
ˌrezəˈveɪʃn|ˌrezərˈveɪʃn}-{reservation}-{a dinner reservation}-{n. 保留； 预订，预约； 保留地，专用地；|,|\
ˈrezəvwɑ:(r)|ˈrezərvwɑ(r)}-{reservoir}-{She found she had reservoirs of unexpected strength.}-{n. 蓄水池； 贮液器； 储藏； 蓄积|,|\
rɪˈzɪstənt|rɪˈzɪstənt}-{resistant}-{heat-resistant/stain-resistant/fire-resistant etc ;resistant to}-{adj. 有抵抗力的，抵抗的； 顽固的；|n. 抵抗者； 有抵抗力的东西； 防染剂，防腐剂；|,|\
rɪˈspektɪv|rɪˈspektɪv}-{respective}-{the respective roles of teachers and students}-{adj. 各自的，分别的；|,|\
ˈrestləs|ˈrɛstlɪs}-{restless}-{become/grow/get restless}-{adj. 焦躁不安的； 不耐烦的； 坐立不安的； 难以入睡的|,|\
rɪ'zju:m|rɪ'zjum}-{resume}-{resume your seat/place/position ;resume doing something ;a brief résumé of the day’s events}-{v. 重新开始； 继续； 恢复职位；|,|\
rɪˈtri:t|rɪˈtrit}-{retreat}-{retreat to/from/into etc}-{vi. 撤退，后退； 撤销，作罢； （眼睛等）凹进； [航]向后倾斜|n. 撤回； 静居处； 引退期间； 静思，静修|,|\
ri:ˈju:niən|riˈjunjən}-{reunion}-{an annual reunion}-{n. 重聚，（亲友等的）聚会； 再结合，再合并； 再统一；|,|\
rɪˈvendʒ|rɪˈvɛndʒ}-{revenge}-{take one's revenge on sb;revenge yourself on somebody}-{n. 报仇，报复；|vt. 为…报仇，报…之仇；|,|\
rɪˈvəʊlt|rɪˈvoʊlt}-{revolt}-{revolt against sb/sth}-{vt. （使）厌恶；|vi. 反叛，背叛； 厌恶，反感；|n. 造反，起义；|,|\
rɪˈvɒlv|rɪˈvɑlv}-{revolve}-{revolve around/about sth}-{vt.& vi. 使旋转； 反复考虑； 使循环；|vi. 旋转； 循环出现； 反复考虑；|,|\
rɪb|rɪb}-{rib}-{a rib of beef}-{n. 肋骨； （船或屋顶等的）肋拱； 肋骨状的东西； （织物的）凸条花纹|vt. 嘲笑，逗弄，开（某人的）玩笑； 装肋于，给…装肋材；|,|\
ˈrɪbən|ˈrɪbən}-{ribbon}-{a winding ribbon of water}-{n. 带； （打印机的）色带； 绶带； 带状物|v. 把…撕成条带； 用缎带装饰； 形成带状；|,|\
rɪdʒ|rɪdʒ}-{ridge}-{the ridge of a wave bridge}-{n. 背脊，峰，隆起线； 山脊，山脉，海脊； 高压脊； 皱摺，田埂|vt. 使成脊状，使隆起；|vi. 使成脊状；|,|\
ˈraɪfl|ˈraɪfəl}-{rifle}-{pistol ,The killer had rifled his wallet and stolen £200.}-{n. 步枪； 来福枪；|vt.& vi. 快速搜寻； 匆忙翻找 ； 偷窃； 盗取|,|\
ˈraɪət|ˈraɪət}-{riot}-{urban riots ;University students rioted in protest at tuition fees.}-{n. 骚乱，暴动，暴乱，骚动，混乱； 放荡，闹饮，嘈闹的宴会，喝酒狂闹； 五色缤纷，喧嚣嘈杂； （想像，感情等的）奔放|vi. 暴动，闹事； 放荡；|vt. 浪费； 挥霍；|,|\
raɪp|raɪp}-{ripe}-{ripe peaches.;be ripe for something}-{adj. 成熟的； 醇美可口的； 老练的； 时机成熟的|v. 〈诗〉同“ripen“；|,|\
rɔ:(r)|rɔr, ror}-{roar}-{roar out an order}-{vi. 咆哮； 喧闹； 吼叫； 混乱或吵闹|vt. 大声喊出； 使…轰鸣； 吼，咆啸；|n. 吼叫声，咆哮声，呼啸声； 狂笑，大笑；|,|\
rəʊst|roʊst}-{roast}-{roast the chicken}-{vt.& vi. 烤，烘，焙；|vt. 嘲讽，挖苦；|n. 烤肉； 户外烧烤野餐；|adj. 烤好的，烤制的；|,|\
ˈrɒbə(r)|ˈrɑbə(r)}-{robber}-{Armed robbers}-{n. 强盗，盗贼；|,|\
ˈrɒbəri|ˈrɑbəri}-{robbery}-{bank robberies}-{n. 抢劫案； 明抢； 敲竹杠； 明目张胆地索取高价|,|\
ˈrɒkɪt|ˈrɑkɪt}-{rocket}-{Interest rates rocketed up to}-{n. 火箭； 火箭发射器； 火箭发动机； 芝麻菜|vi. 飞快地移动； 急速上升；|vt. 用火箭运送； 用火箭攻击；|,|\
rɒd|rɑd}-{rod}-{steel/iron/wooden etc rod}-{n. 杆，拉杆； 惩罚，体罚； （责打人用的）棍棒； 手枪|,|\
ˈrəʊlə(r)|ˈroʊlə(r)}-{roller}-{a paint roller}-{n. 滚筒； 滚压机； 定型卷夹，塑料发卷； 巨浪|,|\
rəʊˈmæns|ˈroʊˈmæns}-{romance}-{the romance of Hollywood}-{n. 浪漫史； 爱情小说； 恋爱； 传奇色彩|vt.& vi. 虚构； 渲染； 谈情说爱； 追求某人|,|\
rəʊˈmæntɪk|roʊˈmæntɪk}-{romantic}-{romantic love}-{adj. 浪漫的，谈情说爱的，多情的，风流的，香艳的； 空想的，虚构的，怪诞的，想入非非的，不实际的，难实行的（计划等）； 传奇（式）的，小说般的，情节离奇的； 浪漫主义的|n. 富于浪漫气息的人； 浪漫主义作家[画家等]，浪漫派诗人[艺术家]； 浪漫思想[行为]；|,|\
rəʊˈteɪt|ˈroʊteɪt}-{rotate}-{The Earth rotates on its axis}-{vt.& vi. （使某物）旋转； 使转动； 使轮流，轮换； 交替|adj. [植]辐状的； 有辐射部分的；|,|\
ˈrɒtn|ˈrɑtn}-{rotten}-{a rotten idea}-{adj. 腐烂的； 恶臭的； 堕落的； 极坏的|adv. 非常； 极其；|,|\
raʊz|raʊz}-{rouse}-{rouse sb from depression}-{v. 叫醒，惊醒； 鼓励，鼓舞； 使发脾气； 使振奋|n. 觉醒； 奋起； [军]<英>起床号； 干杯|vi. 醒来； 奋起；|,|\
ˈrɔɪəlti|ˈrɔɪəlti}-{royalty}-{treated them like royalty .}-{n. 王族成员； 版税； 王位，王权； 堂皇，庄严|,|\
rʌg|rʌɡ}-{rug}-{a rug covered the hardwood floors}-{n. 小块地毯； 〈英〉（围盖膝的）围毯，车毯； 〈美俚男子假发；|,|\
ru:mə|ˈrumɚ}-{rumor}-{rumour about/of}-{n. <美>传闻； [古]名誉； 咕哝； [古]喧嚷|vt. 谣传； 传说；|,|\
ˈru:mə(r)|ˈrumɚ}-{rumour}-{U.S. officials are discounting rumours of a coup.}-{n. 传闻，谣言； 流言；|vt. 谣传；|,|\
rʌst|rʌst}-{rust}-{rust away}-{n. 铁锈； 锈病，锈菌； 荒废，停滞； 锈，锈色|vt.& vi. （使）生锈； [植]害锈病； 变钝，荒废；|,|\
ˈsækrɪfaɪs|ˈsækrəˌfaɪs}-{sacrifice}-{personal sacrifice . ;sacrifice something for something}-{n. 牺牲； 献祭，供奉； 牺牲行为； [宗]基督的献身|vt.& vi. 牺牲，把…奉献给…； 廉价卖出； 牺牲，献祭； [棒]作牺牲打|vt. 献祭； 奉献； 牺牲； 亏本出售|,|\
ˈsædl|ˈsædl}-{saddle}-{be saddled with}-{n. 马鞍； （自行车或摩托车的）车座； 鞍形架，鞍状物； （动物的）脊肉|vt.& vi. 给（马）装鞍；|vt. 使承担；|,|\
ˈseɪlə(r)|ˈselɚ}-{sailor}-{the drowned sailor}-{n. 水手，海员； 驾船人；|,|\
seɪnt|sent}-{saint}-{the patience of a saint ;}-{n. 圣人般的人（指特别善良、仁爱或有耐性的人）； 圣…（冠于人名、地名之前）； （因其生死言行而被基督教会追封的）圣人； 圣徒|vt. 成为圣徒； 把…视为圣徒；|,|\
ˈseɪlzmən|ˈselzmən}-{salesman}-{an insurance salesman}-{n. 推销员； 售货员，店员；|,|\
ˈsæŋkʃn|ˈsæŋkʃən}-{sanction}-{US sanctions against Cuba ;be sanctioned by something}-{n. 制裁，处罚； 批准，认可； 约束力； 鼓励|vt. 批准； 鼓励，容忍；|,|\
ˌsætɪsˈfæktəri|ˌsætɪsˈfæktəri}-{satisfactory}-{satisfactory to/for ;satisfactory result/outcome/resolution}-{adj. 令人满意的； 符合要求的； [神]赎罪的；|,|\
ˈsɔ:sə(r)|ˈsɔsɚ}-{saucer}-{a china cup and saucer}-{n. 茶杯托，茶碟； （放花盆的）垫盘（等）； 浅碟形盆地； 〈美〉拳击场|,|\
skæn|skæn}-{scan}-{I scanned the page for her name. ;have a quick scan;}-{vt. <计>扫描； 细看； 细查； （雷达）对…进行扫描|n. 扫描； 浏览； 审视； （雷达）（屏面上的）光点|vi. （光束、雷达等）扫描； 扫略； （诗歌）符合韵律； 标出诗歌的格律|,|\
ˈskændl|ˈskændl}-{scandal}-{a sex scandal}-{n. 丑闻，丑名，丑事，丑行，丢脸的事件，舞弊案件，耻辱； 流言蜚语； 闲话； 诽谤|,|\
skeəs|skers}-{scarce}-{the scarce resources .}-{adj. 缺乏的，罕见的；|adv. 勉强； 仅仅； 几乎不； 简直不|,|\
ˈskeəsli|ˈskersli}-{scarcely}-{can/could scarcely do something}-{adv. 几乎不，简直不； 刚刚，才； 决不； （刚）一…就|,|\
skeə(r)|sker}-{scare}-{scare somebody into something ;a health scare}-{vt. 使惊恐，惊吓； 使害怕，使恐惧； 把…吓跑；|vi. 受惊吓； 感到害怕；|n. 惊恐，惊吓； 恐惧； 恐慌；|adj. 骇人的，令人恐惧的； 引起恐慌的； 用以吓唬人的；|,|\
skɑ:f|skɑrf}-{scarf}-{She scarfed down a bagel on her way to work. (eat)}-{n. 围巾，领巾； 嵌接； 桌巾，台巾； （木材，金属，皮革的）嵌接|v. 围（围巾）； 打（领带）； 披（披巾）； 用围巾[台布]围[盖]|,|\
ˈskætə(r)|ˈskætɚ}-{scatter}-{scatter (something) over/around/across etc something}-{vt. （使）散开，（使）分散，驱散；|vi. 撒开； 分散；|n. 撒布，散播；|,|\
ˈsi:nəri|ˈsinəri}-{scenery}-{the fantastic scenery.}-{n. 风景，景色； 舞台布景； 风景画； 舞台面|,|\
ˈskɒlə(r)|ˈskɑlə(r)}-{scholar}-{scholars and researchers.}-{n. 奖学金获得者； 学者； 聪颖勤奋的学生； 〈俚〉有文化的人，有某种文科知识的人|,|\
ˈskɒləʃɪp|ˈskɑlərʃɪp}-{scholarship}-{She won a scholarship to Iowa State University. ;a drama scholarship.}-{n. 奖学金； 学术； 学识；|,|\
ˈsɪzəz|ˈsɪzərz}-{scissors}-{a pair of scissors}-{n. 剪刀； 两腿前后错跃；|v. 剪开( scissor的第三人称单数)； 作剪式移动（尤指腿）；|,|\
skəʊld|skoʊld}-{scold}-{scold sb}-{vt. 责骂；|vi. 责骂； 斥责；|n. 常骂人的人；|,|\
skaʊt|skaʊt}-{scout}-{boy scout ;I’m scouting round for a place to stay.}-{n. 搜索，侦察； 侦察员， 侦察机， 侦察舰 , 童子军； （牛津大学的）校工；|vt. 侦察； 跟踪，监视； 发现；|vi. 侦察； 巡视； 嘲笑；|,|\
skreɪp|skrep}-{scrape}-{scrape my knee on the sidewalk}-{vt. 擦，刮； 擦去； 擦伤，刮破； 挖空|vi. 刮，擦； 搔，抓； 掏； 发出刺耳的声音|n. 擦，刮； 刮痕； 刮擦声； 刮胡子，修面|,|\
ˈskru:tənaɪz|ˈskrutnˌaɪz}-{scrutinize}-{She scrutinized his face.;scrutiny n. 详细审查；监视；细看；选票复查}-{vt. 仔细检查；|n. 仔细或彻底检查；|,|\
ˈsi:mɪŋli|ˈsiːmɪŋli}-{seemingly}-{seemingly unaware/oblivious ;seemingly endless/impossible}-{adv. 看来似乎； 表面上看来； 貌似；|,|\
ˈsegmənt|ˈsɛɡmənt}-{segment}-{segments of}-{n. 部分，段落； 环节； [计算机]（字符等的）分段； [动物学]节片|vt.&vi. 分割，划分； [生]使分裂；|,|\
ˈselfɪʃ|ˈsɛlfɪʃ}-{selfish}-{selfish behaviour}-{adj. 自私的，利己的；|,|\
sɪˈmestə(r)|səˈmɛstɚ}-{semester}-{the fall semester}-{n. （尤指美国的大专院校的）学期； 半学年；|,|\
ˌsemikənˈdʌktə(r)|sɛmikənˈdʌktɚ}-{semiconductor}-{the semiconductor industry}-{n. <物>半导体；|,|\
ˈsemɪnɑ:(r)|ˈsɛməˌnɑr}-{seminar}-{attend the seminar .}-{n. 研讨班，讲习会； 研讨小组； 研讨会； 培训会|,|\
ˈsenət|ˈsɛnɪt}-{senate}-{The Senate approved the bill.}-{n. 参议院（美国、法国、澳大利亚等国家的两个立法机构之一）； 上院； 某些国家的)大学理事会； 大学评议会|,|\
ˈsenətə(r)|ˈsɛnətɚ}-{senator}-{Senator Kennedy}-{n. 参议员；|,|\
ˌsensəˈtɪvəti|ˌsɛnsɪˈtɪvɪti}-{sensitivity}-{a teacher with great sensitivity ; show a sensitivity to}-{n. 敏感，感受性； 仪器等的)灵敏性； [摄]感光度；|,|\
ˈʃæləʊ|ˈʃæloʊ}-{shallow}-{shallow water}-{adj. 浅的，肤浅的； 表面的，皮毛的； （水，器物等）浅的； （呼吸）浅的|n. 浅处； 浅滩；|v. 使变浅； 使变浅薄；|,|\
ʃɪə(r)|ʃɪr}-{sheer}-{the sheer weight/size etc of ;sheer off/away}-{v. （使）偏航，（使）转向；|adv. 完全地，全然； 垂直地，陡峭地；|n. 舷弧； 单锚系泊的船位； 偏离的方向； 船体型线|adj. 完全的，全然的； 极薄的； 几乎垂直地，陡峭的； 绝对的|,|\
ʃi:ld|ʃild}-{shield}-{shield against ;shield somebody/something from somebody/something}-{n. 盾； 护罩； 盾形奖牌； 保护人|vt. 保护； 掩护； 庇护； 给…加防护罩|,|\
ˈʃɪvə(r)|ˈʃɪvɚ}-{shiver}-{shiver with cold}-{n. 发抖，颤抖； 碎块，破片；|vi. 战栗，发抖；|vt. 由于航行时太靠近风而使（帆）颤动；|,|\
ˈʃɔ:tɪdʒ|ˈʃɔrtɪdʒ}-{shortage}-{a shortage of skilled labour}-{n. 不足，缺点； 缺少； 缺少量； 不足额|,|\
ˈʃɔ:tkʌmɪŋ|ˈʃɔrtkʌmɪŋ}-{shortcoming}-{shortcoming of /in}-{n. 短处，缺点；|,|\
ʃrɪŋk|ʃrɪŋk}-{shrink}-{shrink from something ;The city continued to shrink.}-{vt.& vi. 收缩，皱缩； （使）缩水； 退缩，畏缩；|n. 收缩； 畏缩； <俚>精神病学家；|,|\
ˈsaɪdweɪz|ˈsaɪdˌwez}-{sideways}-{He would be moved sideways, rather than demoted.}-{adv. 斜着，斜向一边； 以侧面对着；|adj. 斜向一边的；|,|\
saɪ|saɪ}-{sigh}-{sigh heavily/deeply ;give/let out/heave a sigh}-{vi. 叹气； 悲叹，悲鸣；|vt. 叹气地说；|n. 叹气，叹气声；|,|\
ˈsaɪtsi:ɪŋ|ˈsaɪtˌsiɪŋ}-{sightseeing}-{a sightseeing bus}-{n. 观光，游览；|,|\
sɪmˈplɪsəti|sɪmˈplɪsɪti}-{simplicity}-{For the sake of simplicity,}-{n. 简单，朴素； 质朴，天真； 卑贱； 无知|,|\
ˈsɪmplɪfaɪ|ˈsɪmpləˌfaɪ}-{simplify}-{an attempt to simplify the tax system}-{vt. 简化； 使单纯； 使简易；|,|\
sɪnˈsɪə(r)|sɪnˈsɪr}-{sincere}-{sincere friendship}-{adj. 真诚的，诚挚的； 〈古〉纯粹的，不掺假的； 真心实意的； 真实的|,|\
ˈsɪŋgjələ(r)|ˈsɪŋɡjəlɚ}-{singular}-{the singular form of ;a singular achievement}-{adj. <语>单数的； <正>突出的； 奇特的； 非凡的|n. 单数形式（的词）；|,|\
sketʃ|skɛtʃ}-{sketch}-{sketch map;I’d like to sketch in a few details for you.}-{n. 草图； 素描； 梗概；|v. 草拟； 速写； 简述；|,|\
skɪld|skɪld}-{skilled}-{skilled at/in}-{adj. 熟练的，有技能的； 需要技能的； 娴；|,|\
skɪlfʊl|ˈskɪlfəl}-{skillful}-{skilful at (doing) something}-{adj. 灵巧的，熟练的； 制作精巧的； 圆熟；|,|\
skɪm|skɪm}-{skim}-{The ball skims through/over sth;After simmering the meat, skim the fat from the surface.}-{v. 略读； 撇去； 使掠过； （为逃税而）隐瞒（部分收入）|adj. 脱脂的； 撇去浮沫的；|n. 撇； 撇去的东西； 瞒报所得的收入；|,|\
slæm|slæm}-{slam}-{slam the lid down;We heard a car door slam.}-{vt. 砰地关上（门或窗）； 猛烈抨击； 使劲一推； 猛劲一摔|vi. 砰然关上； 猛力打击，碰撞； 撞到了一辆卡车上；|n. 猛然关闭的声音； 猛击；|,|\
slæp|slæp}-{slap}-{slap somebody on the back}-{n. 掌掴； 掌掴声； 侮辱；|vt. 猛打； 用力放置； 尖刻批评、侮辱；|vi. 拍击；|adv. 直接地； 猛然地；|,|\
sli:v|sliv}-{sleeve}-{a dress with long sleeves}-{n. [机]套筒，套管； 袖子，袖套； 唱片套；|vt. 给…装袖子； 给…装套筒；|,|\
ˈslendə(r)|ˈslɛndɚ}-{slender}-{slender legs/arms/fingers etc}-{adj. 苗条的； 微薄的； 柔弱的；|,|\
ˈslɪpəri|ˈslɪpəri}-{slippery}-{wet and slippery}-{adj. 狡猾的； 滑溜的； 不可靠的；|,|\
ˈsləʊgən|ˈsloʊgən}-{slogan}-{campaign slogan}-{n. 标语，口号； 呐喊声； （商业广告上用的）短语；|,|\
smæʃ|smæʃ}-{smash}-{smash a window;smashed to pieces .}-{vt. 打碎； 撞击； 猛扣（球等）；|vi. 被击碎； 扣球，抽杀；|,|\
ˈsmʌgl|ˈsmʌɡəl}-{smuggle}-{He smuggled his notes into the exam.}-{vt. 偷运； 私运； 走私； 不按规章地偷带（人或物）|vi. 走私； 偷带；|,|\
snæk|snæk}-{snack}-{I grabbed a quick snack.}-{n. 快餐，点心； 加餐；|vi. 吃快餐；|,|\
səʊk|soʊk}-{soak}-{soak in sth/water;steep}-{vt. 浸泡，浸透； 吸入； 沉浸在（工作或学习中）； 湿透|vi. 浸泡； 渗透或浸透，渗出； 讲话者暂停了一下； [俚语] 酗酒|n. 湿透； 酒鬼； 浸湿性； [俚语]醉汉|,|\
sɔ:(r)|sɔr, sor}-{soar}-{Her temperature soared.}-{vi. 高飞； 飞腾； 猛增，剧增； 高耸，屹立|n. 高飞； 高涨； 高飞范围； 上升高度|vt. 高飞越过； 飞升到；|,|\
ˈsəʊʃəlɪzəm|ˈsoʊʃəlɪzəm}-{socialism}-{It believed in socialism}-{n. 社会主义；|,|\
ˈsəʊʃəlɪst|ˈsoʊʃəlɪst}-{socialist}-{popular among socialists}-{n. 社会主义者；|adj. 社会主义的； 社会党的；|,|\
ˈsəʊdə|ˈsoʊdə}-{soda}-{a can of orange soda}-{n. 苏打； 碳酸钠； 苏打水，汽水； 苏打点心|,|\
ˈsəʊlə(r)|ˈsoʊlə(r)}-{solar}-{a solar eclipse}-{adj. 太阳的，日光的； 利用太阳能的； 根据太阳决定或测定的；|n. 日光浴室；|,|\
ˈsɒləm|ˈsɑləm}-{solemn}-{a solemn vow}-{adj. 庄严的，严肃的； 庄重的； 隆重的，神圣的； 犹豫的，阴沉的|,|\
ˈsɒlətri|ˈsɑləteri}-{solitary}-{the solitary goal of the match ;a long, solitary walk}-{adj. 独自的，独立的； 单个的； 唯一的； 隐居的|n. 独居者，隐士； 单独禁闭；|,|\
səˈfɪstɪkeɪtɪd|səˈfɪstɪˌketɪd}-{sophisticated}-{a sophisticated, witty American ;sophisticated software}-{adj. 复杂的； 精致的； 富有经验的； 深奥微妙的|v. 使变得世故； 使迷惑； 篡改(sophisticate的过去分词形式)；|,|\
ˈsɒrəʊ|ˈsɑroʊ}-{sorrow}-{a time of great sorrow}-{n. 悲痛； 悔恨，惋惜； 伤心事；|vt.& vi. 悲痛； 遗憾；|,|\
ˈsaʊə(r)|saʊr}-{sour}-{a sour knee;turn/go sour ;sour cherries}-{adj. 有酸味的； 敌对的； 坏脾气的； 别扭的|vi. 变酸，变馊； 发酵； 厌烦； 败坏|vt. 变坏，恶化； 使变酸； 使失望； 使不毛|n. 酸味； 苦事；|,|\
səʊ|soʊ}-{sow}-{sow a field with wheat;strew}-{vt.& vi. 播（种），播种于；|vt. 灌输； 激起； 散布； 煽动|n. 母猪；|,|\
ˈspeɪskrɑ:ft|ˈspeɪskræft}-{spacecraft}-{unmanned spacecraft}-{n. [航天]宇宙飞船，航天器；|,|\
speɪd|sped}-{spade}-{shovel}-{n. 铁锹，铲子； 纸牌中的)黑桃；|vt. 铲；|,|\
spæn|spæn}-{span}-{over/within/in a span of something ;a career which spanned nearly 60 years}-{n. 共轭（马、骡）； 跨度，墩距； 一段时间； [航] 跨绳|vt. 缚住或扎牢； 跨越时间或空间； 以掌测量； 以手围绕测量类似测量|,|\
spɑ:k|spɑrk}-{spark}-{sparks from the fire ; spark sb’s interest/hope/curiosity etc}-{n. 燃烧的颗粒； 火星，火花，余火； （金属的）发光的颗粒； 电火花|vi. 发出火星，发出闪光； 热烈赞同； 正常运转；|vt. 发动，触发； 激起运动，鼓舞；|,|\
ˈspeʃəlaɪz|ˈspɛʃəˌlaɪz}-{specialize}-{Simmons specialized in contract law.}-{vi. 专门从事； 专攻； 详细说明； 特化|vt. 使专门化； 使适应特殊情况； 详细说明； 列举|,|\
ˈspesɪmən|ˈspɛsəmən}-{specimen}-{specimens of rocks}-{n. 样品； 范例； （化验的）抽样； 某种类型的人|,|\
spekˈtækjələ(r)|spɛkˈtækjəlɚ}-{spectacular}-{a spectacular victory}-{adj. 场面富丽的，壮观的； 引人注意的； 惊动一时的； 惊人的|n. 壮观的场面，精彩的表演； 〈美〉一小时半以上的大场面电视节目； 特大霓虹灯广告；|,|\
ˈspekjuleɪt|ˈspɛkjəˌlet}-{speculate}-{speculate about/on/upon the future}-{vt. 思索，猜测，推测；|vi. 投机； 推测； 思索；|,|\
ˈspaɪdə(r)|ˈspaɪdɚ}-{spider}-{red spider}-{n. 蜘蛛； 星形轮，十字叉； 带柄三脚平底锅； 三脚架|,|\
spɪt|spɪt}-{spit}-{spit at/on/into ;spit something out}-{vt. 吐，吐出；|n. 唾沫； 口水； 烤肉叉；|vi. 吐痰，吐口水； 发出劈啪声；|,|\
splæʃ|splæʃ}-{splash}-{The ocean splashed against the pier.}-{vt. 使（液体）溅起；|vi. （指液体）溅落；|n. （光、色等的）斑点； 溅泼声； 溅上的斑点； 溅泼的量|,|\
ˈsplendɪd|ˈsplɛndɪd}-{splendid}-{a splendid opportunity}-{adj. 壮观的，豪华的； 极好的或令人满意的； 闪亮的； 为众人所推崇的|,|\
ˈspɒnsə(r)|ˈspɑnsə(r)}-{sponsor}-{a major sponsor of the Olympics. ;The bank had offered to sponsor him at university.}-{n. 发起者，主办者； 担保者； 倡议者，提案人； 后援组织|vt. 赞助；|,|\
spɜ:(r)|spɚ}-{spur}-{a pair of spurs;His misfortunes spurred him to write.}-{n. 马刺； 激励因素； 支柱； （公路或铁路的）支线|vt. 策（马）前进； （尤指用马刺）策（马）加速； 鞭策；|vi. 策马飞奔； 急速前进；|,|\
stæk|stæk}-{stack}-{a stack of ;stack them on the shelves.}-{n. 垛，干草堆； （一排）烟囱； 层积； 整个的藏书架排列|vt.& vi. 堆成堆，垛； 堆起来或覆盖住； 洗牌作弊； 秘密事先运作|,|\
ˈsteɪdiəm|ˈstediəm}-{stadium}-{the new Olympic Stadium}-{n. 运动场； 体育场； [医]（疾病的第…）期；|,|\
steɪn|sten}-{stain}-{stained with dust;remove/get rid of a stain}-{vi. 弄脏； 污染； 被玷污；|vt. 玷污，染污； 败坏（名声）； 给…染色；|n. 污点； 瑕疵； 着色剂； 色斑|,|\
steɪl|stel}-{stale}-{the smell of stale smoke}-{adj. 陈腐的； 不新鲜的； 走了味的；|v. 变陈旧； 变得不新鲜； （牛马、骆驼等）撒尿；|n. （牛马、骆驼的）尿；|,|\
ˈstændpɔɪnt|ˈstændˌpɔɪnt}-{standpoint}-{from a theoretical/political/economic etc standpoint ;point of view}-{n. 立场，观点；|,|\
ˈstætɪk|ˈstætɪk}-{static}-{remain static}-{adj. 静止的； 不变的； 静电的； [物]静力的|n. 静电； [物]静电（干扰）； 静力学； 争吵|,|\
ˈsteɪʃənri|ˈsteɪʃəneri}-{stationary}-{remain stationary 停着不动}-{adj. 不动的，固定的； 静止的，不变的； 常备军的； 定居的|n. 不动的人； 驻军； 固定物；|,|\
stə'tɪstɪkl|stəˈtɪstɪkəl}-{statistical}-{statistical evidence}-{adj. 统计的； 统计学的；|,|\
stə'tɪstɪks|stəˈtɪstɪks}-{statistics}-{the official crime statistics ;}-{n. 统计，统计学，统计法，统计资料； 统计数字； “statistic”的复数；|,|\
ˈstætʃu:|ˈstætʃu}-{statue}-{Statues of Lenin}-{n. 雕像，塑像；|vt. 用雕像装饰；|,|\
ˈsti:mə(r)|ˈstimɚ}-{steamer}-{The steamer touched at 3 ports.}-{n. 汽船，轮船； 蒸锅； 蒸汽机； 用蒸汽工作的人|,|\
stɪə(r)|stɪr}-{steer}-{steer somebody towards/away from/through etc something}-{vt.& vi. 驾驶； 操纵，控制； 引导；|vt. 掌（舵）；|vi. 行进；|n. 阉公牛，肉用公牛； 〈美俚〉建议； 关于行路（或驾驶）的指示；|,|\
stem|stɛm}-{stem}-{long-stemmed ;stem the growth/rise/decline etc}-{n. （花草的）茎； 词干； （高脚酒杯的）脚； 烟斗柄|vt. 遏制[阻止]（液体的流动等）； 阻止； 封堵； 遏止|,|\
ˈsteriəʊ|ˈsterioʊ}-{stereo}-{a stereo with good speakers ;stereo equipment}-{adj. 立体声的； 有立体感的；|n. 立体声； 立体声系统； 铅板； 立体系统或立体像片|,|\
stɜ:n|stɜrn}-{stern}-{stern warning/rebuke}-{adj. 严厉的，严峻的； 坚定的，不动摇的； 严肃的；|n. 船尾，艉； 末端； 斯坦恩，英语男子名；|,|\
ˈstɪki|ˈstɪki}-{sticky}-{a sticky floor}-{adj. 粘性的； 热湿的，闷热的； 极不愉快的； 不动的|,|\
ˈstɪmjuleɪt|ˈstɪmjəˌlet}-{stimulate}-{stimulate growth/demand/the economy}-{vt. 刺激； 激励，鼓舞； 使兴奋；|vi. 起兴奋作用； 起促进作用； 起刺激作用；|,|\
stɪŋ|stɪŋ}-{sting}-{Her harsh words stung him into action. ;a bee sting}-{vt. 叮，螫； 刺痛； 精神上刺痛； 刺激|vi. 感到剧痛； 刺，叮；|n. 螫伤处； （某些昆虫的）毒刺； （身体或心灵的）剧痛； （警察为抓捕罪犯而设的）圈套|,|\
ˈstɒkɪŋ|ˈstɑkɪŋ}-{stocking}-{in your stockinged/stocking feet}-{n. 长袜； 似长袜之物；|,|\
stu:p|stup}-{stoop}-{stoop down/to | stoop low to do}-{n. 门廊，游廊； 自贬； 弯腰，驼背； 屈服|vt.& vi. 屈服，忍辱； 弯腰； 倾斜； 自贬|,|\
stəʊv|stoʊv}-{stove}-{on the stove}-{n. 炉，火炉； 窑； 干燥室，烘房；|v. 用火炉烤；|,|\
stræp|stræp}-{strap}-{a bra strap;soldiers with grenades strapped to their belts}-{v. 用带捆扎； 用皮带抽打； 拼命工作；|n. 带子； 皮带； 磨刀皮带； 鞭打|,|\
ˈstraɪkɪŋ|ˈstraɪkɪŋ}-{striking}-{striking contrast/similarity/parallel etc}-{adj. 显著的； 引人注目的； 容貌出众的； 妩媚动人的|v. 打( strike的现在分词)； 击； 敲响； 报时|,|\
straɪp|straɪp}-{stripe}-{vertical/horizontal stripes}-{n. 条纹； 种类； 军士军阶； 犯人穿的横条囚衣|vt. 使带有条纹；|,|\
səbˈdʒektɪv|səbˈdʒɛktɪv}-{subjective}-{a highly subjective point of view ;subjective judgment/opinion etc}-{adj. 主观的； 个人的； 内省的；|,|\
səbˈmɜ:dʒ|səbˈmɜrdʒ}-{submerge}-{be submerged by water merge}-{vt.& vi. 淹没； 把…浸入； 沉没，下潜； 使沉浸|vt. 淹没； 把…浸入； 沉浸；|vi. 淹没； 潜入水中； 湮没；|,|\
səbˈtrækt|səbˈtrækt}-{subtract}-{subtract sth from}-{vt. 减去； 扣除；|,|\
ˈsʌbɜ:b|ˈsʌbɜrb}-{suburb}-{a London suburb}-{n. 郊区，城郊； 边缘； 附近，周围；|,|\
ˈsʌbweɪ|ˈsʌbˌwe}-{subway}-{the New York City subway}-{n. 地铁； 地下通道；|,|\
su:|su}-{sue}-{sue (somebody) for libel/defamation/negligence/slander}-{vt.& vi. 控告，控诉，和…打官司； 请求； 起诉； 提起（诉讼）要求判决|,|\
ˈsu:ɪsaɪd|ˈsuɪˌsaɪd}-{suicide}-{commit suicide}-{n. 自杀； 自杀者； 自杀行为；|vt. 自杀；|adj. 自杀的；|,|\
ˈsʌmɪt|ˈsʌmɪt}-{summit}-{the summit of something ;a five-nation summit meeting}-{n. 顶点； 高层会议； 最高阶层；|adj. 最高级的； 政府首脑的；|,|\
ˈsʌnlaɪt|ˈsʌnˌlaɪt}-{sunlight}-{morning/afternoon/evening sunlight}-{n. 阳光；|,|\
ˈsʌnraɪz|ˈsʌnˌraɪz}-{sunrise}-{at sunrise}-{n. 日出（时分），黎明； <诗>日出的地方，东方；|,|\
ˈsʌnset|ˈsʌnˌsɛt}-{sunset}-{at sunset}-{n. 日落（时），薄暮； 晚霞； 黄昏；|adj. 定期废止的；|,|\
ˈsʌnʃaɪn|ˈsʌnˌʃaɪn}-{sunshine}-{afternoon/morning/evening sunshine}-{n. 阳光，日光； 晴朗，晴天； 太阳晒着的地方； 欢乐|,|\
ˌsu:pəˈfɪʃl|ˌsupərˈfɪʃl}-{superficial}-{superficial understanding a superficial similarity}-{adj. 表面（上）的； 肤浅的，缺乏深度的； 一知半解的；|,|\
su:ˈpɪəriə(r)|suˈpɪriə(r)}-{superior}-{Your computer is far superior to mine. ;relationship with his immediate superior}-{adj. （级别、地位）较高的； （在质量等方面）较好的； （数量）较多的； 上等的|n. 上级； 较好的人[事物]，优胜者； 修道院院长； 方丈|,|\
su:ˈpri:m|sʊˈprim}-{supreme}-{the supreme sacrifice. Supreme Court 最高法院}-{adj. 最高的； 至高的，无上的； 最重要的； （程度）很大的|,|\
ˈsɜ:dʒən|ˈsɜrdʒən}-{surgeon}-{dental surgeon}-{n. 外科医生； [军]军医；|,|\
səˈpɑ:s|sərˈpæs}-{surpass}-{surpass sb in speed, strength, skill}-{vt. 超过； 优于； 胜过； 非…所能办到|,|\
ˈsɜ:pləs|ˈsɜrpləs}-{surplus}-{surplus funds;a surplus of crude oil}-{adj. 过剩的； 多余的；|n. 剩余额； 公积金； 顺差； 盈余|,|\
səˈrendə(r)|səˈrɛndɚ}-{surrender}-{surrender oneself to sb}-{vi. 投降； 屈服； 自首；|vt. 使投降； 放弃； 交出； 听任|n. 投降； 放弃； 屈服； （保险的）解约|,|\
səˈraʊndɪŋz|səˈraʊndɪŋz}-{surroundings}-{work in pleasant surroundings.}-{n. （周围的）环境[事物]； 环境，周围的事物( surrounding的名词复数)； 一带；|,|\
ˈswɒləʊ|ˈswɑloʊ}-{swallow}-{n v wallow;Jane was soon swallowed up in the crowd.}-{vt.& vi. 吞，咽； 忍耐，忍受；|vt. 不流露； <口>忍受，轻信；|n. [鸟]燕子； 胃管，食道； 一次吞咽的量； （滑车等的）通索孔|,|\
sweɪ|swe}-{sway}-{Don’t allow yourself to be swayed by his promises.}-{vi. 摇摆； 歪，倾斜； 改变；|vt. 使前后或来回摇摆； 使倾斜； [航海]升起桅杆；|n. 摇摆； 支配，统治；|,|\
swel|swɛl}-{swell}-{The river was swollen with melted snow. ; swell with pride/anger}-{vt.& vi. 增强； 肿胀； 膨胀； 充满（激情）|n. 汹涌； 重要人士； （尤指身体部位）凸起的形状； 声音渐强|adj. 极好的； 了不起的； 非常棒的；|,|\
swɪft|swɪft}-{swift}-{a swift reply;They were swift to deny the accusations.}-{adj. 迅速的； 敏捷的； 立刻的； 突然发生的|n. 雨燕； 环球金融同业电讯会； [人]斯威夫特，《格利佛游记》作者；|adv. 迅速地，敏捷地；|,|\
swɪs|swɪs}-{Swiss}-{swiss bank}-{adj. （人）来自瑞士的； 瑞士的，瑞士文化的；|n. 瑞士人；|,|\
sɔ:d|sɔrd}-{sword}-{put somebody to the sword}-{n. 剑，刀； 武力，战争； 兵权，权力；|,|\
ˌsɪmpəˈθetɪk|ˌsɪmpəˈθɛtɪk}-{sympathetic}-{sympathetic to/towards}-{adj. 同情的，有同情心的； 赞同的； 相投合的，称心的； 〈口〉抱好感的|,|\
ˈsɪmpəθaɪz|ˈsɪmpəˌθaɪz}-{sympathize}-{I can sympathize with those who have lost loved ones.}-{vi. 同情，怜悯； 共鸣，同感； 支持，赞成； 安慰|,|\
ˈsɪmptəm|ˈsɪmtəm, ˈsɪmp-}-{symptom}-{a symptom of}-{n. 症状； 征兆；|,|\
sɪnˈθetɪk|sɪnˈθɛtɪk}-{synthetic}-{synthetic method;synthetic fibres/materials/fabrics}-{adj. 合成的； 人造的； 摹拟的，虚构的； [语]综合的|n. 合成物； 合成纤维； 合成剂；|,|\
ˌsɪstəˈmætɪk|ˌsɪstəˈmætɪk}-{systematic}-{systematical;a systematic approach/way/method}-{adj. 有系统的，有规则的； 有条不紊的； 有步骤的； 一贯的，惯常的|,|\
tæg|tæɡ}-{tag}-{name/identity/price tag ;be tagged (as) something}-{vt. 加标签于； 附加； 起诉； 紧跟|vi. 跟在…后面； 随从；|n. 标签； 附属物； 口头禅； 称呼|,|\
ˈteɪlə(r)|ˈtelɚ}-{tailor}-{The classes are tailored to suit learners’ needs.}-{n. 裁缝，成衣工；|vi. 做裁缝；|vt. 调整使适应； 为…裁制衣服； 为…做衣服； 剪裁，制作|,|\
teɪm|tem}-{tame}-{tame elephants ;The Asian elephant can be tamed and trained.}-{adj. 驯服的； 平淡的； 无精打采的；|v. 驯服； 抑制；|,|\
tekˈnɪʃn|tɛkˈnɪʃən}-{technician}-{a laboratory technician}-{n. 技术人员； 技师； 技巧纯熟的人；|,|\
ˈti:diəs|ˈtidiəs}-{tedious}-{a tedious speech}-{adj. 单调沉闷的； 冗长乏味的； 令人生厌的；|,|\
ˈti:neɪdʒə(r)|ˈtinˌedʒɚ}-{teenager}-{teenage adj.十几岁的;a TV sex education series aimed at teenagers}-{n. 十几岁的青少年； 十三岁到十九岁的少年；|,|\
ˌtelɪkəˌmju:nɪ'keɪʃn|ˈtɛlɪkəˌmjunɪˈkeʃən}-{telecommunication}-{the telecommunications industry}-{n. 电信； 电通信；|,|\
ˈtelɪskəʊp|ˈtelɪskoʊp}-{telescope}-{through a telescope ;The front of the car telescoped when it hit the wall.}-{n. 望远镜；|vt.& vi. （使某物）变短（叠缩在一起）； （使某物）叠缩，嵌入；|vt. 压缩某物使其少占空间或时间；|,|\
ˈtempə(r)|ˈtɛmpɚ}-{temper}-{quick/bad/fiery etc temper ;temper something with/by something}-{n. 性情，脾气； 特征； （钢等）回火； 怒气|vt. 调和； 使回火； 锻炼； 缓和|vi. 使调和；|,|\
ˈtempl|ˈtɛmpəl}-{temple}-{a small Hindu temple}-{n. 庙，寺； 耶路撒冷古神殿； [犹太教] 犹太教聚会； 太阳穴|,|\
tempˈteɪʃn|tɛmpˈteʃən}-{temptation}-{temptation to do something}-{n. 诱惑，引诱； 诱惑物；|,|\
ˈtendə(r)|ˈtɛndɚ}-{tender}-{tender plants}-{adj. 纤弱的； 嫩的； 温柔的； 疼痛的|n. （正式）提出； 投标； 供应船，联络船； 照看者|vt. 正式提出； 使变脆弱； <古>温柔地对待；|,|\
təˈrɪfɪk|təˈrɪfɪk}-{terrific}-{a terrific storm;That’s a terrific idea!}-{adj. 极好的； 异乎寻常的； 很大的； 了不起的|,|\
ˈtekstaɪl|ˈtɛksˌtaɪl, -təl}-{textile}-{textile industry/design/manufacture etc}-{n. 纺织品，织物； 纺织业；|,|\
ˈθerəpi|ˈθɛrəpi}-{therapy}-{have /undergo therapy}-{n. 治疗，疗法，疗效； 心理治疗； 治疗力；|,|\
ˌðeərˈɑ:ftə(r)|ˌðerˈæftə(r)}-{thereafter}-{shortly thereafter}-{adv. 此后，在那之后； 〈罕〉据此；|,|\
ðeə'fɔ:|ðer'fɔ}-{therefor}-{Their car was bigger and therefore more comfortable.}-{adv. 为此，因此；|,|\
θəˈmɒmɪtə(r)|θərˈmɑmɪtə(r)}-{thermometer}-{digital thermometer}-{n. 温度计； 体温表；|,|\
ˈθɪŋkɪŋ|ˈθɪŋkɪŋ}-{thinking}-{way of thinking ;the thinking man’s pop band}-{n. 思考； 想法，思想； 意见； 见解|adj. 有思想的； 有理性的；|v. “think”的现在分词；|,|\
θɜ:st|θɜrst}-{thirst}-{quench my thirst ;young men thirsting for adventure}-{n. （口）渴； 渴感； 长期的干渴；|vi. 渴望； 口渴；|,|\
ˈθʌrə|ˈθɜroʊ}-{thorough}-{The doctor gave him a thorough check-up.}-{adj. 彻底的，全面的，充分的，彻头彻尾的，根本的，详尽的，严密的； 十足的，考虑周到的； 非常精确的，（对细节）不厌其烦的； 绝对的，完善的|prep. 〈古〉同“through”；|n. [英史]专横政策；|,|\
ˈθɔ:tfl|ˈθɔtfəl}-{thoughtful}-{a thoughtful essay}-{adj. 沉思的； 体贴的； 缜密思考过的，深思熟虑的；|,|\
θred|θrɛd}-{thread}-{needle and thread. ;a common thread running within his work}-{n. 线； 线索； 线状物； 螺纹|vt. 穿成串； 将（针、线等）穿过…； 用…线缝； 给…装入（胶片、狭带、绳子）|,|\
θraɪv|θraɪv}-{thrive}-{plants that thrive in tropical rain forests}-{vi. 兴盛，兴隆； 长得健壮； 茁壮成长；|,|\
θrʌst|θrʌst}-{thrust}-{thrust sth into}-{vt.& vi. 猛推； 逼迫； 强行推入； 延伸|n. 刺； 推力； [军]突击； [地]逆断层|vi. 插入； 用力向某人刺去； 猛然或用力推；|,|\
θʌm|θʌm}-{thumb}-{a baby sucking its thumb ;I began thumbing through the pages}-{n. 拇指； （手套的）拇指部份；|vi. 翘起拇指请求搭乘（过路汽车），示意请求搭便车； 翻阅；|vt. 翻阅； 作搭车手势； 用拇指翻脏[翻坏]（书页等）；|,|\
ˈθʌndə(r)|ˈθʌndɚ}-{thunder}-{We were woken in the night by thunder. ;Guns roared and thundered all around us.}-{n. 雷声； 隆隆的响声；|vi. 打雷；|vt.& vi. 发出隆隆声； 轰隆隆地快速移动； 使快速移动； 怒喝|,|\
taɪd|taɪd}-{tide}-{swim with/against the tide ;tide of violence/crime etc}-{n. 潮汐； 潮流，趋势； 时机； 时期，季节|vt. 顺应潮水航行； 使随潮水漂行；|,|\
ˈtɪmbə(r)|ˈtɪmbɚ}-{timber}-{the timber trade}-{n. 木材，木料； （用于建筑或制作物品的）树木； 用材林，林场； 素质|vt. 用木料支撑； 备以木材；|,|\
ˈtaɪmli|ˈtaɪmli}-{timely}-{in a timely manner/fashion ;a timely reminder (of something)}-{adj. 适时的； 及时的；|,|\
ˈtaɪə(r)|taɪr}-{tire}-{we were tiring fast. ;tyre}-{vt. 使…疲惫； 使…厌烦；|vi. 厌烦； 疲劳；|n. 轮胎； 头饰；|,|\
ˈtɪʃu:|ˈtɪʃu}-{tissue}-{a box of tissues}-{n. 薄纸，棉纸； [生]组织； 一套；|,|\
ˈtəʊkən|ˈtoʊkən}-{token}-{Please accept this gift as a small token of our appreciation. ;with token gestures}-{n. 代币； 象征； 记号；|adj. 作为对某事的保证的； 象征性的； 作为标志的；|vt. 预兆：预示或象征，预兆；|,|\
ˈtɒlərəns|ˈtɑlərəns}-{tolerance}-{tolerance of/towards/for}-{n. 宽容，容忍； 限度； 公差； 耐药量，耐药性|,|\
ˈtɒlərənt|ˈtɑlərənt}-{tolerant}-{a tolerant society}-{adj. 宽容的； 容忍的，忍受的； （植物、动物或机器）能在困难条件下生存（或操作）的； 能耐…的|,|\
ˈtɒləreɪt|ˈtɑləreɪt}-{tolerate}-{I can't tolerate your bad manners any longer.}-{vt. 容许； 承认； 忍受； 容忍（不同意或不喜欢的事物）|,|\
təʊl|toʊl}-{toll}-{The death toll ;Years of smoking have taken their toll on his health.}-{n. 通行费； 伤亡人数； 钟声； 长途电话费|v. 鸣钟； 敲钟；|,|\
tɔ:tʃ|tɔrtʃ}-{torch}-{the Olympic torch ;Rioters torched several abandoned cars.}-{n. 火把，火炬； 手电筒；|vt.& vi. 放火烧，纵火烧（建筑物或汽车）；|,|\
ˈtɔ:tʃə(r)|ˈtɔrtʃə(r)}-{torture}-{the torture of jealousy;tortured by jealousy}-{n. 拷问； 折磨； 痛苦； （精神上或肉体上的）折磨|vt. 使痛苦； 使苦恼； 使焦急； 曲解|,|\
trækt|trækt}-{tract}-{vast tracts of woodland ;the digestive/reproductive/urinary etc tract}-{n. 大片土地； （神经纤维的）束； 小册子； <古>一段时间，长时间|,|\
ˈtræktə(r)|ˈtræktɚ}-{tractor}-{The tractor hauled the fertilizer away}-{n. 拖拉机； 牵引器；|,|\
ˈtrædʒədi|ˈtrædʒɪdi}-{tragedy}-{The tragedy happened as they were returning home from a night out.}-{n. 悲剧，惨剧； 悲剧文学； 悲剧理论，悲剧表演艺术； 悲剧式作品|,|\
treɪl|trel}-{trail}-{Susie trailed along behind her parents.}-{vt. 跟踪，追踪； 拖曳：让…拖或飘扬在后面； 拖沓而行； 跟在…后面|vi. （在比赛等中）输； （尤指跟在他人后面）疲惫地走； （在比赛或其他竞赛中）落后； 蔓生|n. 足迹； 臭迹； 小径； 一缕|,|\
ˈtrænziənt|ˈtrænziənt}-{transient}-{the transient of human life}-{adj. 短暂的； 转瞬即逝的； 临时的；|n. 临时旅客； 瞬变现象； 候鸟；|,|\
trænsˈleɪʃn|trænsˈleʃən, trænz-}-{translation}-{a literal translation from Arabic}-{n. 翻译； 译本； 转变； 转化|,|\
trænsˈpærənt|trænsˈpærənt}-{transparent}-{be transparent to the user.}-{adj. 透明的； 清澈的； 易识破的； 显而易见的|,|\
træp|træp}-{trap}-{lay/set a trap (for somebody) ;trap somebody into (doing) something}-{vt. 诱骗； 使受限制； 困住； 使（水与气体等）分离|n. 圈套； （对付人的）计谋； （练习射击用的）抛靶器； （捕捉动物的）夹子|vi. 设陷阱； 装捕捉机； 设圈套；|,|\
ˈtrembl|ˈtrɛmbəl}-{tremble}-{tremble with anger/fear etc}-{vi. 发抖； 焦虑； 颤动； 轻轻摇晃|n. 震颤，发抖； 颤动，震动； 摇晃； 战栗|vt. 使挥动； 用颤抖的声音说出； 颤动，震动； 焦虑，担忧|,|\
ˈtraɪæŋgl|ˈtraɪˌæŋɡəl}-{triangle}-{a triangle of land}-{n. 三角形； 三人一组； 三角铁； 三角板|,|\
trɪm|trɪm}-{trim}-{trim something from/off something ;a trim figure}-{vt. 修剪； 整理； 装饰；|adj. 整齐的，整洁的； 修长的； 苗条的；|n. 整齐； 修剪； 健康状态； 装束|vi. 削减；|,|\
ˈtraɪʌmf|ˈtraɪəmf}-{triumph}-{shouts of triumph;In the end, good shall triumph over evil.}-{n. 胜利； 巨大的成就； （成功的）典范； （巨大成功或胜利的）心满意足|vi. 获胜； 克服； 打败； 战胜|,|\
ˈtrɒpɪkl|ˈtrɑpɪkl}-{tropical}-{tropical zone 热带}-{adj. 热带的； 炎热的； 热情的；|,|\
ˈtrʌblsəm|ˈtrʌbəlsəm}-{troublesome}-{a troublesome child}-{adj. 令人讨厌的； 令人烦恼的； 引起麻烦的； （孩子等）难管的|,|\
ˈtrʌmpɪt|ˈtrʌmpɪt}-{trumpet}-{They are proudly trumpeting the fact that they are creating more jobs.}-{n. 喇叭； 小号； [乐]音栓； 喇叭似的声音|vt. 大声说出或宣告；|vi. 吹喇叭，吹小号； 发出回声；|,|\
trʌŋk|trʌŋk}-{trunk}-{the trunk of an old oak tree ;Put your suitcase in the trunk.}-{n. 树干； 象鼻； 躯干； 汽车车尾的行李箱|,|\
tjuˈɪʃn|tuˈɪʃn}-{tuition}-{I had to have extra tuition in maths.}-{n. 学费； 教学，讲授；|,|\
ˈtɜ:baɪn|ˈtɜrbaɪn}-{turbine}-{gas turbine , wind turbine}-{n. 涡轮机； 汽轮机； 透平机；|,|\
ˈtju:tə(r)|ˈtutə(r)}-{tutor}-{She was my tutor at Durham. ;tutor somebody in something}-{n. 家庭教师； 导师； （大专院校的）助教； 课本|vt.& vi. 当家庭教师； 任大学导师； 任课；|,|\
ˈtaɪpraɪtə(r)|ˈtaɪpˌraɪtɚ}-{typewriter}-{She tapped out a letter on the typewriter}-{n. 打字机；|,|\
ˈtaɪpɪst|ˈtaɪpɪst}-{typist}-{He substituted as the typist in the office}-{n. 打字员；|,|\
ʌmˈbrelə|ʌmˈbrɛlə}-{umbrella}-{beach umbrella ;(come/work etc) under the umbrella of something}-{n. 雨伞； 〈比喻〉保护物； [军]空中掩护幕； 总括|,|\
ʌnˈkʌvə(r)|ʌnˈkʌvɚ}-{uncover}-{uncover a plot}-{vt. 揭开…的盖子； 揭露，发现； 拿下（头上）戴的东西，脱（帽）； 将（狐）赶出|vi. 发现，揭示；|,|\
ˌʌndəˈgrædʒuət|ˌʌndərˈgrædʒuət}-{undergraduate}-{undergraduate student/course/degree etc}-{n. （未获学士学位的）大学生，大学肄业生；|adj. 大学生的，大学的；|,|\
ˈʌndəgraʊnd|ˈʌndərgraʊnd}-{underground}-{an underground passage ;This animal spends most of its life underground.}-{adj. 地下的； 秘密的； 先锋派的； 隐蔽的|,|\
ˌʌndəˈlaɪn|ˌʌndərˈlaɪn}-{underline}-{highlight ;This tragic incident underlines the need for immediate action.}-{vt. 在…下面画线； 加强，强调；|n. 下划线； 下期节目预告； 图下说明文字；|,|\
ʌnˈdu:|ʌnˈdu}-{undo}-{I undid the package carefully. ;He undid his coat.}-{vt. 松开，解开； 取消，废除； 毁灭； 扰乱|vi. 撤销；|,|\
ʌn'daʊtɪdlɪ|ʌn'daʊtɪdlɪ}-{undoubtedly}-{That is undoubtedly true.}-{adv. 毋庸置疑地，的确地； 显然； 必定； 无疑|,|\
ʌnˈi:zi|ʌnˈizi}-{uneasy}-{felt uneasy about}-{adj. 心神不安的； 不稳定的； 不舒服的；|,|\
ˌʌnɪkˈspektɪd|ˌʌnɪkˈspektɪd}-{unexpected}-{Her death was totally unexpected .}-{adj. 想不到的，料不到的； 意外的； 忽然的； 突然的|,|\
juˈnaɪt|juˈnaɪt}-{unite}-{unite against/behind}-{vt. （使）联合，合并，统一； 并有，兼备； 混合，化合；|vi. （为某事）联合，联手，团结；|,|\
ˌʌnˈləʊd|ˌʌnˈloʊd}-{unload}-{unload something from something}-{vt. 卸货； 去除负担； 倾吐； 处理，倾销|vi. 卸下货物或其它负担； 退子弹； [商]抛售（证券）；|,|\
ˈʌpraɪt|ˈʌpˌraɪt}-{upright}-{upright posture;sit/stand/walk upright}-{adj. 直立的； 垂直的； 正直的； 诚实的|adv. 垂直[竖立]地；|n. （支撑用的）直柱，立放构件；|,|\
ʌptə'deɪt|ˌʌptəˈdet}-{up-to-date}-{up-to-date information/data/figures/news etc}-{adj. 现代的，最新的； 最近的； 新式的；|,|\
ˈju:sɪdʒ|ˈjusɪdʒ, -zɪdʒ}-{usage}-{a book on modern English usage}-{n. 使用； 用法； 习惯； 惯例|,|\
ˈʌtməʊst|ˈʌtmoʊst}-{utmost}-{with the utmost care;the utmost importance}-{adj. 极度的，最大的，最远的；|n. 极限，最大限度；|,|\
ˈʌtə(r)|ˈʌtɚ}-{utter}-{utter darkness;without uttering a word .}-{vt. 发出声音； 说，讲； 出版（书籍）等； [法]流通使用|adj. 彻底的，完全的，绝对的；|,|\
ˈveɪkənt|ˈvekənt}-{vacant}-{a vacant situation, post, hotel room}-{adj. 空闲的； 空缺的； 空虚的； 茫然的|,|\
ˈvækjuəm|ˈvækjuəm}-{vacuum}-{create/leave a vacuum (in something) ;}-{n. 真空； 空白； 空虚； 清洁|v. 用真空吸尘器清扫；|,|\
veɪn|ven}-{vain}-{Men can be just as vain as women.}-{adj. 徒劳的； 自负的； 无结果的； 无用的|,|\
ˈvænɪʃ|ˈvænɪʃ}-{vanish}-{vanish into nothing}-{vi. 消失； 突然不见； 消亡，消灭； [数]化为零|vt. 使消失，使不见；|n. [语音学]消失音，弱化音；|,|\
ˈveɪpə(r)|ˈvepɚ}-{vapour}-{water vapour}-{n. 潮气，水汽； 蒸汽（等于vapor）；|adj. 蒸发的，自夸的；|,|\
ˈventʃə(r)|ˈvɛntʃɚ}-{venture}-{business/commercial venture ;venture to do something ;I ventured to ask}-{n. 冒险事业； 冒险； 冒险行动； 商业冒险|vt. 冒…的危险； 拿…冒险； 用…进行投机； 以…做赌注|vi. 冒险前进，冒险行事； 猜测（常与at连用）；|,|\
ˈverɪfaɪ|ˈvɛrəˌfaɪ}-{verify}-{verify that/whether}-{vt. 核实； 证明； 判定；|,|\
ˈvɜ:səs|ˈvɜrsəs}-{versus}-{the Supreme Court decision in Roe vs. Wade}-{prep. （表示两队或双方对阵）对； （比较两种不同想法、选择等）与…相对； 对抗；|,|\
ˈvɜ:tɪkl|ˈvɜrtɪkl}-{vertical}-{a vertical line ;The tower now leans about 15 degrees from the vertical.}-{adj. 垂直的，竖立的； [解]头顶的； 顶点的； [植]纵长的，直上的|n. 垂直线，垂直面； [建]竖杆； 垂直位置；|,|\
ˈvesl|ˈvɛsəl}-{vessel}-{a fishing vessel ;a burst blood vessel}-{n. 容器； 船，飞船； 血管，管束； …的化身|,|\
vest|vest}-{vest}-{a bulletproof vest;Copyright is vested in the author for 50 years.}-{n. 马甲； 防护衣； 内衣； （印有运动员编号的）运动背心|vi. 合法地被授予； 给自己装上教服；|vt. 授权； 赋予； 穿衣服，穿教服；|,|\
ˈvetərən|ˈvɛtərən}-{veteran}-{a Vietnam veteran}-{n. 经验丰富的人，老兵； 退伍军人；|adj. 有作战经验的； 老兵的； [美国英语]退伍军人的； 老练的，资深的，经验丰富的|,|\
vaɪˈbreɪt|ˈvaɪˌbret}-{vibrate}-{it makes them vibrate.}-{vt.& vi. （使）振动[颤动]； 摆动； 犹豫； 激动|,|\
vaɪs|vaɪs}-{vice}-{Smoking is my only vice.}-{n. 恶习； 不道德行为； （肉体的）缺陷，疾病； （文体等的）缺点，瑕疵|prep. 代替； 取代；|adj. 副的； 代替的；|vt. 用老虎钳夹紧； 钳制；|,|\
ˈvju:pɔɪnt|ˈvjuˌpɔɪnt}-{viewpoint}-{From an ecological viewpoint,}-{n. 观点，意见，角度； 视角； <物>视点；|,|\
ˈvɪgərəs|ˈvɪɡərəs}-{vigorous}-{a vigorous young man}-{adj. 有力的； 精力充沛的； 充满活力的； 朝气蓬勃的|,|\
ˈvɪnɪgə(r)|ˈvɪnɪɡɚ}-{vinegar}-{oil, vinegar}-{n. 醋； 乖戾，尖酸刻薄； <口>充沛的精力；|,|\
ˈvaɪələt|ˈvaɪəlɪt}-{violet}-{beautiful violet eyes}-{n. 紫罗兰； 蓝紫色，紫罗兰色； 堇菜； 羞怯的人|adj. 蓝紫色的； 紫罗兰色的；|,|\
ˌvaɪəˈlɪn|ˌvaɪəˈlɪn}-{violin}-{play the violin.}-{n. 小提琴； 小提琴手；|,|\
ˈvɪtəmɪn|ˈvaɪtəmɪn}-{vitamin}-{Lack of vitamin D is another factor}-{n. 维生素； 维他命；|na. “vitamine“的变体；|,|\
ˈvɪvɪd|ˈvɪvɪd}-{vivid}-{He had a vivid picture of her in his mind.}-{adj. 生动的； （记忆、描述等）清晰的； （人的想像）丰富的； （光、颜色等）鲜艳的，耀眼的|,|\
vəˈkæbjələri|vəˈkæbjəleri}-{vocabulary}-{the vocabulary of politics ;(the word) failure/guilt/compromise etc is not in sb’s vocabulary}-{n. （某一语言的）词汇； （尤指外语教科书中附有释义的）词汇表；|,|\
ˈvəʊkl|ˈvoʊkl}-{vocal}-{vocal opponent/critic/supporter etc ;}-{adj. 声音的，嗓音的； 由嗓音发出或产生的； 有声音的，能发出声音或语言的； 畅所欲言的|n. 元音； [音乐]声乐作品；|,|\
vɒlˈkeɪnəʊ|vɑlˈkeɪnoʊ}-{volcano}-{The volcano erupted last year}-{n. 火山；|,|\
vəʊlt|voʊlt}-{volt}-{a 100-volt microwave oven,}-{n. 伏特； [马术]环骑； [剑]闪避；|,|\
ˈvəʊltɪdʒ|ˈvoʊltɪdʒ}-{voltage}-{high/low voltage}-{n. 电压，伏特数；|,|\
ˈwægən|ˈwæɡən}-{wagon}-{fall off the wagon}-{n. 四轮的运货马车； <英>铁路货车； <美>小手推车； 囚车|vt. 用运货马车运输货物；|na. “waggon”的变体；|,|\
weɪst|west}-{waist}-{from the waist up/down ;stripped to the waist}-{n. 腰，腰部； （衣服的）腰身； 船腰； （女人，小孩子的）背心|,|\
ˈweɪkən|ˈwekən}-{waken}-{She gently wakened the sleeping child.}-{vi. 醒来； 睡醒； 觉醒；|vt. 唤醒，弄醒； 使觉醒；|vt.& vi. （使）觉醒； （使）振奋； 激发；|v. 振起，鼓励；|,|\
ˈwɒlɪt|ˈwɑlɪt}-{wallet}-{in your wallet}-{n. 钱包，皮夹子；|,|\
ˈwɔ:feə(r)|ˈwɔrfer}-{warfare}-{chemical/nuclear/germ etc warfare}-{n. 战争，战争状态； 斗争，冲突； 军事行为； 兵火|,|\
wɔ:mθ|wɔrmθ}-{warmth}-{the warmth of the summer sun}-{n. 温暖，暖和； 热情，热心； 激动； 诚恳|,|\
ˈwɔ:təpru:f|ˈwɔtərpruf}-{waterproof}-{a waterproofed sack}-{adj. 不透水的，防水的； 用防水材料处理过的；|vt. 使防水，使不透水； 给（布）上胶；|n. 防水衣物，雨衣 usually plural； 防水布，油布； 防水物，防水材料；|,|\
wæks|wæks}-{wax}-{a wax candle;wax and wane}-{n. 蜡，蜡状物； 耳垢，耳屎； （鞋匠用的）擦线蜡； 增大|vt. 给…打蜡，给…上蜡； 渐渐变大； 变为； （月亮）渐圆，渐盈|vi. 给…上蜡，给…涂蜡； 把…灌制唱片； 用热蜡除去毛发；|adj. 蜡制的，似蜡的；|,|\
ˈwi:kən|ˈwikən}-{weaken}-{Julia was weakened by her long illness.}-{vt.& vi. （使）削弱； （使）变弱； 衰减； 变得优柔寡断|,|\
ˈwelθi|ˈwɛlθi}-{wealthy}-{the wealthy nations of the world}-{adj. 富有的； 充分的；|n. 富人，有钱人，阔人；|,|\
wi:v|wiv}-{weave}-{weave something together}-{vt.& vi. 编，织； 迂回行进； 穿行（以避开障碍）；|vt. 编排； （把…）编成；|vi. 纺织，织布；|n. 织物； 织法，编法； 编织式样；|,|\
ˈwi:və(r)|ˈwivɚ}-{weaver}-{The weaver fringed the edge of the scarf}-{n. 织工，编织者； [鸟]织巢鸟，[虫]豉豆，织网蜘蛛；|,|\
wi:d|wid}-{weed}-{weed a garden;Cars clogged the roads like weeds.}-{n. 杂草； 大麻； 废物； 烟草|vt. 给…除杂草； 除（草）； 消除；|vi. 除草；|,|\
wi:p|wip}-{weep}-{James broke down and wept.}-{vt.& vi. （通常因悲伤）哭泣； 流泪； 悲哀； 哀悼|vi. （伤口）流血，渗出水汽；|n. 一段哭泣，一阵哭泣；|,|\
weld|wɛld}-{weld}-{weld A and B together}-{vt.& vi. 焊接； 使紧密结合；|n. 焊接点； 黄色植物染料；|,|\
wel'nəʊn|ˈwɛlˈnon}-{well-known}-{well-known for}-{adj. 出名的，众所周知的，熟悉的； 鼎鼎大名； 闻；|,|\
weɪl|hwel, wel}-{whale}-{I had a whale of a time in Fargo;The receding tide stranded the whale}-{n. [动]鲸，鲸鱼； 巨大的事物；|v. 捕鲸； 击打，猛击；|,|\
wɪtʃˈevə(r)|hwɪtʃˈɛvɚ, wɪtʃ-}-{whichever}-{Whichever way you look at it, things are pretty bad.}-{pron. 任何一个； 无论哪个； 究竟哪一个；|adj. 究竟哪个，无论哪些； 无论哪一个；|,|\
waɪlst|hwaɪlst,waɪlst}-{whilst}-{while}-{conj. 同时； 时时，有时； 当…的时候； <英>同“while”|,|\
wɪp|hwɪp, wɪp}-{whip}-{whip something off/out/back etc ;The coachman cracked his whip}-{vt. 鞭打，抽打； 严厉地折磨、责打或责备，迫使； 把…打起泡沫；|vi. 烤，烘； 烘干；|n. 鞭子； 鞭伤，鞭痕； 鞭状物； 组织秘书，立法机构的一员|,|\
ˈwɪsl|ˈwɪsl}-{whistle}-{He whistled a tune ;Sanders gave a low whistle}-{vi. 吹口哨，吹哨子，鸣汽笛； 呼啸； （动物）发出刺耳的叫声； 吹口哨召唤|vt. 由吹口哨而发出； 吹口哨召唤； 用哨声使…行动；|n. 口哨，哨子； 汽笛； 哨声，笛声； 啭鸣声：尖厉高音|,|\
ˈhəʊlli|ˈhoʊlli}-{wholly}-{a wholly satisfactory solution}-{adv. 完全地，全部地； 十足，统统； 专门； 一并|,|\
ˈwaɪdn|ˈwaɪdn}-{widen}-{They’re widening the road.}-{vt.& vi. 放宽，加宽，（使）变宽；|,|\
ˈwɪdəʊ|ˈwɪdoʊ}-{widow}-{a wealthy widow ;his widowed mother}-{n. 寡妇； 遗孀； [牌]放在一边的几张牌； [印]未排足的行|vt. 使成寡妇； 从…夺走； 杀死…的丈夫；|,|\
wɪdθ|wɪdθ, wɪθ, wɪtθ}-{width}-{What’s the width of the desk?}-{n. 宽度； 广度；|,|\
ˈwɪzdəm|ˈwɪzdəm}-{wisdom}-{a man of great wisdom}-{n. 智慧，明智； 常识，好的判断力； 知识，学问； 古训|,|\
wɪt|wɪt}-{wit}-{quick/dry/sharp etc wit}-{n. 机智； 才智，智慧； 富有机智的人； 打趣话，玩笑话|,|\
wɪðˈstænd|wɪθˈstænd, wɪð-}-{withstand}-{withstand attacks, pressure, wind}-{vt. 经受，承受，禁得起； 反抗；|vi. 反抗； 耐得住，禁得起；|,|\
wʊlf|wʊlf}-{wolf}-{a wolf in sheep’s clothing ;gobble}-{n. 狼； 贪婪的人； 有害的幼虫；|vt. 狼吞虎咽；|,|\
ˈwɜ:kmən|ˈwɜrkmən}-{workman}-{A bad workman always blames his tools}-{n. 工人； 技工，工匠；|,|\
ˈwɜ:ldwaɪd|ˈwɜrldwaɪd}-{worldwide}-{a worldwide reputation}-{adj. 全世界的；|adv. 遍及全球地；|,|\
wɜ:m|wɜrm}-{worm}-{She never misses a chance to worm her way into the public's hearts;The worm inched along}-{n. 虫，蠕虫； （昆虫的）幼虫； 寄生虫； 懦夫|vt.& vi. 蠕动，曲折行进； 给（动物）驱肠虫； 使缓慢前进；|,|\
ˈwɜ:ʃɪp|ˈwɜrʃɪp}-{worship}-{He absolutely worships her.}-{vt. 崇拜，尊崇； 爱慕；|vi. 做礼拜； 热爱； 爱慕； 崇拜（尤指达到看不到缺点的地步）|n. （对治安官或市长的尊称）阁下； 尊敬； 崇拜； 礼拜|,|\
ˈwɜ:θləs|ˈwɜrθləs}-{worthless}-{The house was full of worthless junk.}-{adj. 无价值的，不值钱的； 卑微的； 不足取的，不足道的； 不足轻重|,|\
ˌwɜ:θˈwaɪl|ˌwɜrθˈwaɪl}-{worthwhile}-{it is worthwhile to do something}-{adj. 值得做的； 值得花时间的； 有价值的； 合算|,|\
ˈwɜ:ði|ˈwɜrði}-{worthy}-{a goal that was worthy of any of the great footballers of the world}-{adj. 应得某事物； 值得做某事； 可尊敬的； 配得上的，相称的|n. 杰出人物，伟人；|,|\
rek|rɛk}-{wreck}-{The cave wrecked this morning;It was drink that wrecked their marriage.}-{vt. 破坏，毁坏； 拆除； 使遇难；|n. 毁灭，失事； 遇难船的残骸； （身体或精神上）受到严重损伤的人； 状况非常糟糕的车辆（或建筑物等）|vi. 使（船舶）失事，使遇难，使下沉；|,|\
rɪst|rɪst}-{wrist}-{on/around your wrist}-{n. 腕，手腕； 腕关节； （衣袖等的）腕部；|,|\
ˈeks reɪ|'eksreɪ}-{X-ray}-{.}-{n. X光照片；|vt. 照X光；|,|\
jɔ:n|jɔn}-{yawn}-{The pit yawned open in front of them.}-{vi. 打呵欠； 张开，裂开； <文学>张开大口；|n. 呵欠； 无聊的人或事； 裂口；|,|\
ˈjɪəli|ˈjɪrli}-{yearly}-{their yearly meetings;pay fees in advance, yearly}-{adj. 每年的，一年一度的； 一年间的；|adv. 每年，一年一度； 在那一年间；|n. 年利； 年鉴；|,|\
ji:ld|jild}-{yield}-{yield to ; yield a reasonable return .}-{vt. 屈服，投降； 生产； 获利； 不再反对|vi. 放弃，屈服； 生利； 退让，退位；|n. 产量，产额； 投资的收益； 屈服，击穿； 产品|,|\
ˈzebrə|ˈzibrə}-{zebra}-{zebra crossing ;camels, zebra, bison}-{n. 斑马；|adj. 有斑纹的；|,|\
phonetic}-{word}-{definitions_d}-{definitions_e}-{definitions_c}-{|,|";

var wordCount = 1211;
